month,state,handgun,long_gun,total,population
2020-03,Alabama,34897,17850,52747,4779736
2020-03,Arizona,46377,19346,65723,6392017
2020-03,Arkansas,15304,8968,24272,2915918
2020-03,California,81543,48616,130159,37253956
2020-03,Colorado,43322,22756,66078,5029196
2020-03,Connecticut,9196,3290,12486,3574097
2020-03,Delaware,4936,2323,7259,897934
2020-03,District of Columbia,148,5,153,601723
2020-03,Florida,117900,38365,156265,18801310
2020-03,Georgia,44107,16807,60914,9687653
2020-03,Idaho,11611,8193,19804,1567582
2020-03,Illinois,44112,17127,61239,12830632
2020-03,Indiana,45695,22724,68419,6483802
2020-03,Iowa,378,5778,6156,3046355
2020-03,Kansas,16715,8964,25679,2853118
2020-03,Kentucky,28268,15315,43583,4339367
2020-03,Louisiana,25038,10278,35316,4533372
2020-03,Maine,7794,5310,13104,1328361
2020-03,Maryland,6534,16181,22715,5773552
2020-03,Massachusetts,9765,5100,14865,6547629
2020-03,Michigan,50368,28985,79353,9883640
2020-03,Minnesota,18708,17222,35930,5303925
2020-03,Mississippi,18567,8714,27281,2967297
2020-03,Missouri,41905,22607,64512,5988927
2020-03,Montana,6755,5895,12650,989415
2020-03,Nebraska,217,3623,3840,1826341
2020-03,Nevada,13530,4712,18242,2700551
2020-03,New Hampshire,14278,6190,20468,1316470
2020-03,New Jersey,4531,6000,10531,8791894
2020-03,New Mexico,13558,7181,20739,2059179
2020-03,New York,9257,39906,49163,19378102
2020-03,North Carolina,2488,31949,34437,9535483
2020-03,North Dakota,4122,3717,7839,672591
2020-03,Ohio,63707,28817,92524,11536504
2020-03,Oklahoma,25804,13873,39677,3751351
2020-03,Oregon,33659,18838,52497,3831074
2020-03,Pennsylvania,81319,22031,103350,12702379
2020-03,Rhode Island,2533,2303,4836,1052567
2020-03,South Carolina,25288,10790,36078,4625364
2020-03,South Dakota,5536,4230,9766,814180
2020-03,Tennessee,49546,25157,74703,6346105
2020-03,Texas,147714,61827,209541,25145561
2020-03,Utah,13908,8665,22573,2763885
2020-03,Vermont,3853,2636,6489,625741
2020-03,Virginia,51801,24208,76009,8001024
2020-03,Washington,32624,20165,52789,6724540
2020-03,West Virginia,11570,8599,20169,1852994
2020-03,Wisconsin,42224,18582,60806,5686986
2020-03,Wyoming,4155,3349,7504,563626
2020-02,Alabama,24590,12531,37121,4779736
2020-02,Arizona,16839,8006,24845,6392017
2020-02,Arkansas,8112,5453,13565,2915918
2020-02,California,35570,22645,58215,37253956
2020-02,Colorado,19931,11285,31216,5029196
2020-02,Connecticut,5341,1961,7302,3574097
2020-02,Delaware,2103,1386,3489,897934
2020-02,District of Columbia,97,4,101,601723
2020-02,Florida,59653,20306,79959,18801310
2020-02,Georgia,19173,8207,27380,9687653
2020-02,Idaho,5286,4371,9657,1567582
2020-02,Illinois,22743,9761,32504,12830632
2020-02,Indiana,25949,12739,38688,6483802
2020-02,Iowa,220,2419,2639,3046355
2020-02,Kansas,7905,5610,13515,2853118
2020-02,Kentucky,15294,8763,24057,4339367
2020-02,Louisiana,12303,6564,18867,4533372
2020-02,Maine,3920,2871,6791,1328361
2020-02,Maryland,4472,5622,10094,5773552
2020-02,Massachusetts,5745,2711,8456,6547629
2020-02,Michigan,14668,9092,23760,9883640
2020-02,Minnesota,11142,9395,20537,5303925
2020-02,Mississippi,11638,6114,17752,2967297
2020-02,Missouri,23420,14384,37804,5988927
2020-02,Montana,3343,3196,6539,989415
2020-02,Nebraska,177,1764,1941,1826341
2020-02,Nevada,6215,2706,8921,2700551
2020-02,New Hampshire,6031,2740,8771,1316470
2020-02,New Jersey,4603,3580,8183,8791894
2020-02,New Mexico,7615,4152,11767,2059179
2020-02,New York,9861,13360,23221,19378102
2020-02,North Carolina,1984,13177,15161,9535483
2020-02,North Dakota,2122,2471,4593,672591
2020-02,Ohio,29360,14843,44203,11536504
2020-02,Oklahoma,16480,8203,24683,3751351
2020-02,Oregon,16784,10360,27144,3831074
2020-02,Pennsylvania,53384,15473,68857,12702379
2020-02,Rhode Island,1307,723,2030,1052567
2020-02,South Carolina,14700,6120,20820,4625364
2020-02,South Dakota,3359,3195,6554,814180
2020-02,Tennessee,32364,15464,47828,6346105
2020-02,Texas,60512,29259,89771,25145561
2020-02,Utah,4153,3460,7613,2763885
2020-02,Vermont,1870,1514,3384,625741
2020-02,Virginia,36608,20509,57117,8001024
2020-02,Washington,18044,9505,27549,6724540
2020-02,West Virginia,8200,6163,14363,1852994
2020-02,Wisconsin,17509,11891,29400,5686986
2020-02,Wyoming,2322,1975,4297,563626
2020-01,Alabama,22478,12598,35076,4779736
2020-01,Arizona,15126,7087,22213,6392017
2020-01,Arkansas,6621,5524,12145,2915918
2020-01,California,34884,22057,56941,37253956
2020-01,Colorado,19614,11451,31065,5029196
2020-01,Connecticut,5820,2187,8007,3574097
2020-01,Delaware,2096,1524,3620,897934
2020-01,District of Columbia,124,4,128,601723
2020-01,Florida,54985,19973,74958,18801310
2020-01,Georgia,14422,7886,22308,9687653
2020-01,Idaho,4359,3607,7966,1567582
2020-01,Illinois,22567,9588,32155,12830632
2020-01,Indiana,22340,12461,34801,6483802
2020-01,Iowa,198,2030,2228,3046355
2020-01,Kansas,6624,5196,11820,2853118
2020-01,Kentucky,12022,7558,19580,4339367
2020-01,Louisiana,10706,7687,18393,4533372
2020-01,Maine,3534,2661,6195,1328361
2020-01,Maryland,4283,5213,9496,5773552
2020-01,Massachusetts,5182,2833,8015,6547629
2020-01,Michigan,11806,8250,20056,9883640
2020-01,Minnesota,9445,7565,17010,5303925
2020-01,Mississippi,8790,5922,14712,2967297
2020-01,Missouri,20436,13149,33585,5988927
2020-01,Montana,2884,3010,5894,989415
2020-01,Nebraska,110,1923,2033,1826341
2020-01,Nevada,5250,2413,7663,2700551
2020-01,New Hampshire,5771,2913,8684,1316470
2020-01,New Jersey,4349,3639,7988,8791894
2020-01,New Mexico,6783,3648,10431,2059179
2020-01,New York,10227,12610,22837,19378102
2020-01,North Carolina,1836,12908,14744,9535483
2020-01,North Dakota,1771,2258,4029,672591
2020-01,Ohio,24218,13069,37287,11536504
2020-01,Oklahoma,14939,8277,23216,3751351
2020-01,Oregon,15332,9167,24499,3831074
2020-01,Pennsylvania,46160,13636,59796,12702379
2020-01,Rhode Island,1279,844,2123,1052567
2020-01,South Carolina,11488,5795,17283,4625364
2020-01,South Dakota,2782,2897,5679,814180
2020-01,Tennessee,28938,14788,43726,6346105
2020-01,Texas,53796,29103,82899,25145561
2020-01,Utah,3552,2959,6511,2763885
2020-01,Vermont,1500,1278,2778,625741
2020-01,Virginia,36391,21424,57815,8001024
2020-01,Washington,18390,8842,27232,6724540
2020-01,West Virginia,6543,5664,12207,1852994
2020-01,Wisconsin,14521,9835,24356,5686986
2020-01,Wyoming,2135,1656,3791,563626
2019-12,Alabama,33020,25882,58902,4779736
2019-12,Arizona,18178,10423,28601,6392017
2019-12,Arkansas,8671,10957,19628,2915918
2019-12,California,40637,30780,71417,37253956
2019-12,Colorado,22531,16681,39212,5029196
2019-12,Connecticut,5655,2215,7870,3574097
2019-12,Delaware,2075,2301,4376,897934
2019-12,District of Columbia,101,1,102,601723
2019-12,Florida,67435,31580,99015,18801310
2019-12,Georgia,21514,17664,39178,9687653
2019-12,Idaho,6745,7111,13856,1567582
2019-12,Illinois,24792,13258,38050,12830632
2019-12,Indiana,26770,18746,45516,6483802
2019-12,Iowa,271,4421,4692,3046355
2019-12,Kansas,8092,8653,16745,2853118
2019-12,Kentucky,16185,14471,30656,4339367
2019-12,Louisiana,14237,16743,30980,4533372
2019-12,Maine,3651,4119,7770,1328361
2019-12,Maryland,4175,6878,11053,5773552
2019-12,Massachusetts,4516,2789,7305,6547629
2019-12,Michigan,14303,14075,28378,9883640
2019-12,Minnesota,9835,11241,21076,5303925
2019-12,Mississippi,12935,14538,27473,2967297
2019-12,Missouri,26084,22222,48306,5988927
2019-12,Montana,4169,5522,9691,989415
2019-12,Nebraska,173,3205,3378,1826341
2019-12,Nevada,6307,3636,9943,2700551
2019-12,New Hampshire,5471,3255,8726,1316470
2019-12,New Jersey,3747,4341,8088,8791894
2019-12,New Mexico,7794,5184,12978,2059179
2019-12,New York,8899,16654,25553,19378102
2019-12,North Carolina,2559,22945,25504,9535483
2019-12,North Dakota,2155,3171,5326,672591
2019-12,Ohio,31054,23312,54366,11536504
2019-12,Oklahoma,19110,14320,33430,3751351
2019-12,Oregon,17610,14016,31626,3831074
2019-12,Pennsylvania,53180,20278,73458,12702379
2019-12,Rhode Island,1117,794,1911,1052567
2019-12,South Carolina,14905,11857,26762,4625364
2019-12,South Dakota,3264,4482,7746,814180
2019-12,Tennessee,35893,26800,62693,6346105
2019-12,Texas,69732,53386,123118,25145561
2019-12,Utah,5893,6783,12676,2763885
2019-12,Vermont,1610,1613,3223,625741
2019-12,Virginia,37790,29539,67329,8001024
2019-12,Washington,20508,11752,32260,6724540
2019-12,West Virginia,8815,9944,18759,1852994
2019-12,Wisconsin,17195,14486,31681,5686986
2019-12,Wyoming,3293,3077,6370,563626
2019-11,Alabama,24005,19212,43217,4779736
2019-11,Arizona,13775,8180,21955,6392017
2019-11,Arkansas,6814,9628,16442,2915918
2019-11,California,34345,25063,59408,37253956
2019-11,Colorado,17950,13946,31896,5029196
2019-11,Connecticut,4908,2321,7229,3574097
2019-11,Delaware,1684,2063,3747,897934
2019-11,District of Columbia,103,1,104,601723
2019-11,Florida,54799,24497,79296,18801310
2019-11,Georgia,16171,13002,29173,9687653
2019-11,Idaho,4875,5774,10649,1567582
2019-11,Illinois,21597,12115,33712,12830632
2019-11,Indiana,21903,17950,39853,6483802
2019-11,Iowa,348,4487,4835,3046355
2019-11,Kansas,7143,7349,14492,2853118
2019-11,Kentucky,12094,12686,24780,4339367
2019-11,Louisiana,11282,13282,24564,4533372
2019-11,Maine,2839,4424,7263,1328361
2019-11,Maryland,3447,7153,10600,5773552
2019-11,Massachusetts,4651,2868,7519,6547629
2019-11,Michigan,13255,19391,32646,9883640
2019-11,Minnesota,9148,13550,22698,5303925
2019-11,Mississippi,9210,11603,20813,2967297
2019-11,Missouri,21090,21032,42122,5988927
2019-11,Montana,3032,4517,7549,989415
2019-11,Nebraska,128,2954,3082,1826341
2019-11,Nevada,4892,2873,7765,2700551
2019-11,New Hampshire,4803,3289,8092,1316470
2019-11,New Jersey,3721,3914,7635,8791894
2019-11,New Mexico,6317,4586,10903,2059179
2019-11,New York,8355,18336,26691,19378102
2019-11,North Carolina,2394,18720,21114,9535483
2019-11,North Dakota,1731,3237,4968,672591
2019-11,Ohio,25230,24933,50163,11536504
2019-11,Oklahoma,18679,12894,31573,3751351
2019-11,Oregon,15105,11503,26608,3831074
2019-11,Pennsylvania,49972,22212,72184,12702379
2019-11,Rhode Island,1039,747,1786,1052567
2019-11,South Carolina,11531,9303,20834,4625364
2019-11,South Dakota,2687,4634,7321,814180
2019-11,Tennessee,27826,21101,48927,6346105
2019-11,Texas,57252,41942,99194,25145561
2019-11,Utah,4095,5038,9133,2763885
2019-11,Vermont,1176,1739,2915,625741
2019-11,Virginia,27949,23374,51323,8001024
2019-11,Washington,13487,10163,23650,6724540
2019-11,West Virginia,5980,9834,15814,1852994
2019-11,Wisconsin,15182,18344,33526,5686986
2019-11,Wyoming,2094,2425,4519,563626
2019-10,Alabama,16759,13692,30451,4779736
2019-10,Arizona,11543,7509,19052,6392017
2019-10,Arkansas,4809,7173,11982,2915918
2019-10,California,32128,23005,55133,37253956
2019-10,Colorado,15537,13269,28806,5029196
2019-10,Connecticut,4347,1990,6337,3574097
2019-10,Delaware,1624,1749,3373,897934
2019-10,District of Columbia,113,3,116,601723
2019-10,Florida,47504,19816,67320,18801310
2019-10,Georgia,11105,9858,20963,9687653
2019-10,Idaho,3784,5530,9314,1567582
2019-10,Illinois,17482,10040,27522,12830632
2019-10,Indiana,16204,12595,28799,6483802
2019-10,Iowa,174,2940,3114,3046355
2019-10,Kansas,4917,5227,10144,2853118
2019-10,Kentucky,8759,8890,17649,4339367
2019-10,Louisiana,8450,11231,19681,4533372
2019-10,Maine,2997,5699,8696,1328361
2019-10,Maryland,3372,5731,9103,5773552
2019-10,Massachusetts,4064,2561,6625,6547629
2019-10,Michigan,9550,12790,22340,9883640
2019-10,Minnesota,8762,16263,25025,5303925
2019-10,Mississippi,6506,7086,13592,2967297
2019-10,Missouri,16633,18732,35365,5988927
2019-10,Montana,2612,5541,8153,989415
2019-10,Nebraska,81,2182,2263,1826341
2019-10,Nevada,4402,2573,6975,2700551
2019-10,New Hampshire,4876,3219,8095,1316470
2019-10,New Jersey,3756,3226,6982,8791894
2019-10,New Mexico,5518,3964,9482,2059179
2019-10,New York,8810,16600,25410,19378102
2019-10,North Carolina,1370,12811,14181,9535483
2019-10,North Dakota,1446,3638,5084,672591
2019-10,Ohio,18896,16127,35023,11536504
2019-10,Oklahoma,10536,9256,19792,3751351
2019-10,Oregon,13377,10705,24082,3831074
2019-10,Pennsylvania,44371,17094,61465,12702379
2019-10,Rhode Island,942,698,1640,1052567
2019-10,South Carolina,8542,6648,15190,4625364
2019-10,South Dakota,2216,5161,7377,814180
2019-10,Tennessee,21973,15268,37241,6346105
2019-10,Texas,41994,33957,75951,25145561
2019-10,Utah,2898,3819,6717,2763885
2019-10,Vermont,1283,1860,3143,625741
2019-10,Virginia,20887,15388,36275,8001024
2019-10,Washington,13948,9851,23799,6724540
2019-10,West Virginia,5026,6883,11909,1852994
2019-10,Wisconsin,13148,15376,28524,5686986
2019-10,Wyoming,1594,2368,3962,563626
2019-09,Alabama,14259,12550,26809,4779736
2019-09,Arizona,12126,7629,19755,6392017
2019-09,Arkansas,4535,5063,9598,2915918
2019-09,California,30776,22726,53502,37253956
2019-09,Colorado,14614,12289,26903,5029196
2019-09,Connecticut,4115,1726,5841,3574097
2019-09,Delaware,1397,1378,2775,897934
2019-09,District of Columbia,94,5,99,601723
2019-09,Florida,44565,18261,62826,18801310
2019-09,Georgia,10415,7843,18258,9687653
2019-09,Idaho,3645,4776,8421,1567582
2019-09,Illinois,17639,9512,27151,12830632
2019-09,Indiana,15291,10734,26025,6483802
2019-09,Iowa,131,2288,2419,3046355
2019-09,Kansas,4405,4322,8727,2853118
2019-09,Kentucky,8526,6502,15028,4339367
2019-09,Louisiana,8996,9417,18413,4533372
2019-09,Maine,2919,4439,7358,1328361
2019-09,Maryland,2981,4714,7695,5773552
2019-09,Massachusetts,3523,2370,5893,6547629
2019-09,Michigan,9135,11241,20376,9883640
2019-09,Minnesota,8131,14379,22510,5303925
2019-09,Mississippi,6384,5653,12037,2967297
2019-09,Missouri,15032,13663,28695,5988927
2019-09,Montana,2651,4533,7184,989415
2019-09,Nebraska,63,1631,1694,1826341
2019-09,Nevada,3985,2467,6452,2700551
2019-09,New Hampshire,4458,2948,7406,1316470
2019-09,New Jersey,3760,3285,7045,8791894
2019-09,New Mexico,5517,3752,9269,2059179
2019-09,New York,8316,16334,24650,19378102
2019-09,North Carolina,1306,10756,12062,9535483
2019-09,North Dakota,1489,3300,4789,672591
2019-09,Ohio,17083,13048,30131,11536504
2019-09,Oklahoma,8852,7851,16703,3751351
2019-09,Oregon,12140,10443,22583,3831074
2019-09,Pennsylvania,40203,14471,54674,12702379
2019-09,Rhode Island,837,649,1486,1052567
2019-09,South Carolina,7420,5455,12875,4625364
2019-09,South Dakota,2068,3640,5708,814180
2019-09,Tennessee,20638,13292,33930,6346105
2019-09,Texas,42688,35840,78528,25145561
2019-09,Utah,2892,3430,6322,2763885
2019-09,Vermont,1175,1559,2734,625741
2019-09,Virginia,19517,13336,32853,8001024
2019-09,Washington,12977,8424,21401,6724540
2019-09,West Virginia,4581,5149,9730,1852994
2019-09,Wisconsin,12339,13865,26204,5686986
2019-09,Wyoming,1595,2274,3869,563626
2019-08,Alabama,18831,12672,31503,4779736
2019-08,Arizona,14272,8281,22553,6392017
2019-08,Arkansas,5267,5445,10712,2915918
2019-08,California,36607,25247,61854,37253956
2019-08,Colorado,17237,12352,29589,5029196
2019-08,Connecticut,4806,1785,6591,3574097
2019-08,Delaware,1630,1383,3013,897934
2019-08,District of Columbia,101,5,106,601723
2019-08,Florida,54215,18910,73125,18801310
2019-08,Georgia,12501,8234,20735,9687653
2019-08,Idaho,4039,4604,8643,1567582
2019-08,Illinois,19105,9281,28386,12830632
2019-08,Indiana,19883,11389,31272,6483802
2019-08,Iowa,144,1985,2129,3046355
2019-08,Kansas,5240,4730,9970,2853118
2019-08,Kentucky,10802,6592,17394,4339367
2019-08,Louisiana,10016,8147,18163,4533372
2019-08,Maine,3054,3398,6452,1328361
2019-08,Maryland,3518,4472,7990,5773552
2019-08,Massachusetts,4788,2609,7397,6547629
2019-08,Michigan,9724,8698,18422,9883640
2019-08,Minnesota,8510,11265,19775,5303925
2019-08,Mississippi,9042,7144,16186,2967297
2019-08,Missouri,18605,14755,33360,5988927
2019-08,Montana,2945,3956,6901,989415
2019-08,Nebraska,91,1600,1691,1826341
2019-08,Nevada,4896,2596,7492,2700551
2019-08,New Hampshire,5168,2744,7912,1316470
2019-08,New Jersey,4061,3341,7402,8791894
2019-08,New Mexico,6932,4000,10932,2059179
2019-08,New York,7995,11563,19558,19378102
2019-08,North Carolina,1724,11474,13198,9535483
2019-08,North Dakota,1656,2792,4448,672591
2019-08,Ohio,22222,12658,34880,11536504
2019-08,Oklahoma,10823,8668,19491,3751351
2019-08,Oregon,13926,9496,23422,3831074
2019-08,Pennsylvania,43559,13314,56873,12702379
2019-08,Rhode Island,954,618,1572,1052567
2019-08,South Carolina,9423,6241,15664,4625364
2019-08,South Dakota,2367,3343,5710,814180
2019-08,Tennessee,25754,14536,40290,6346105
2019-08,Texas,49804,36943,86747,25145561
2019-08,Utah,2976,3002,5978,2763885
2019-08,Vermont,1371,1320,2691,625741
2019-08,Virginia,23429,13458,36887,8001024
2019-08,Washington,13689,7551,21240,6724540
2019-08,West Virginia,5846,4737,10583,1852994
2019-08,Wisconsin,13127,11622,24749,5686986
2019-08,Wyoming,1767,2004,3771,563626
2019-07,Alabama,8711,5851,14562,4779736
2019-07,Arizona,11005,5995,17000,6392017
2019-07,Arkansas,4049,3487,7536,2915918
2019-07,California,30400,20830,51230,37253956
2019-07,Colorado,15550,9601,25151,5029196
2019-07,Connecticut,4235,1403,5638,3574097
2019-07,Delaware,1410,936,2346,897934
2019-07,District of Columbia,105,4,109,601723
2019-07,Florida,43914,13570,57484,18801310
2019-07,Georgia,9663,5261,14924,9687653
2019-07,Idaho,3504,3341,6845,1567582
2019-07,Illinois,15782,6889,22671,12830632
2019-07,Indiana,13982,7568,21550,6483802
2019-07,Iowa,113,1264,1377,3046355
2019-07,Kansas,4255,3203,7458,2853118
2019-07,Kentucky,8059,4658,12717,4339367
2019-07,Louisiana,7646,5110,12756,4533372
2019-07,Maine,2322,2161,4483,1328361
2019-07,Maryland,3082,3162,6244,5773552
2019-07,Massachusetts,3711,1886,5597,6547629
2019-07,Michigan,7396,5571,12967,9883640
2019-07,Minnesota,6938,6575,13513,5303925
2019-07,Mississippi,5769,3476,9245,2967297
2019-07,Missouri,14131,10224,24355,5988927
2019-07,Montana,2615,3045,5660,989415
2019-07,Nebraska,80,1047,1127,1826341
2019-07,Nevada,3852,1891,5743,2700551
2019-07,New Hampshire,3874,1996,5870,1316470
2019-07,New Jersey,4160,2590,6750,8791894
2019-07,New Mexico,5219,3365,8584,2059179
2019-07,New York,7051,8051,15102,19378102
2019-07,North Carolina,1265,7650,8915,9535483
2019-07,North Dakota,1219,1942,3161,672591
2019-07,Ohio,15931,9342,25273,11536504
2019-07,Oklahoma,8752,5997,14749,3751351
2019-07,Oregon,11746,7572,19318,3831074
2019-07,Pennsylvania,33850,10017,43867,12702379
2019-07,Rhode Island,788,479,1267,1052567
2019-07,South Carolina,7274,3667,10941,4625364
2019-07,South Dakota,2057,2214,4271,814180
2019-07,Tennessee,19494,10191,29685,6346105
2019-07,Texas,34215,21520,55735,25145561
2019-07,Utah,2558,2495,5053,2763885
2019-07,Vermont,1005,978,1983,625741
2019-07,Virginia,19139,9731,28870,8001024
2019-07,Washington,12636,5788,18424,6724540
2019-07,West Virginia,4289,3610,7899,1852994
2019-07,Wisconsin,9938,6714,16652,5686986
2019-07,Wyoming,1528,1587,3115,563626
2019-06,Alabama,6947,4521,11468,4779736
2019-06,Arizona,11375,5931,17306,6392017
2019-06,Arkansas,4653,3214,7867,2915918
2019-06,California,38712,27050,65762,37253956
2019-06,Colorado,16013,10215,26228,5029196
2019-06,Connecticut,4296,1449,5745,3574097
2019-06,Delaware,1364,907,2271,897934
2019-06,District of Columbia,113,3,116,601723
2019-06,Florida,44378,13576,57954,18801310
2019-06,Georgia,10549,5425,15974,9687653
2019-06,Idaho,3599,3611,7210,1567582
2019-06,Illinois,17041,7321,24362,12830632
2019-06,Indiana,15272,7963,23235,6483802
2019-06,Iowa,117,1299,1416,3046355
2019-06,Kansas,4133,2981,7114,2853118
2019-06,Kentucky,8520,4608,13128,4339367
2019-06,Louisiana,7874,4613,12487,4533372
2019-06,Maine,2616,2091,4707,1328361
2019-06,Maryland,3097,3377,6474,5773552
2019-06,Massachusetts,4203,1808,6011,6547629
2019-06,Michigan,8445,5628,14073,9883640
2019-06,Minnesota,7316,6337,13653,5303925
2019-06,Mississippi,5883,3303,9186,2967297
2019-06,Missouri,14970,10263,25233,5988927
2019-06,Montana,2644,3130,5774,989415
2019-06,Nebraska,109,1089,1198,1826341
2019-06,Nevada,4117,2066,6183,2700551
2019-06,New Hampshire,4138,2310,6448,1316470
2019-06,New Jersey,4273,2652,6925,8791894
2019-06,New Mexico,5389,3203,8592,2059179
2019-06,New York,7400,9047,16447,19378102
2019-06,North Carolina,1411,7908,9319,9535483
2019-06,North Dakota,1286,1942,3228,672591
2019-06,Ohio,17949,9885,27834,11536504
2019-06,Oklahoma,9630,5819,15449,3751351
2019-06,Oregon,12046,8124,20170,3831074
2019-06,Pennsylvania,36023,10325,46348,12702379
2019-06,Rhode Island,787,499,1286,1052567
2019-06,South Carolina,8236,3834,12070,4625364
2019-06,South Dakota,2162,2237,4399,814180
2019-06,Tennessee,20708,9777,30485,6346105
2019-06,Texas,37592,22608,60200,25145561
2019-06,Utah,2803,2571,5374,2763885
2019-06,Vermont,1116,982,2098,625741
2019-06,Virginia,20006,9518,29524,8001024
2019-06,Washington,28670,18920,47590,6724540
2019-06,West Virginia,4894,3738,8632,1852994
2019-06,Wisconsin,11174,7388,18562,5686986
2019-06,Wyoming,1664,1728,3392,563626
2019-05,Alabama,6448,4041,10489,4779736
2019-05,Arizona,11969,5987,17956,6392017
2019-05,Arkansas,4600,3499,8099,2915918
2019-05,California,36314,24718,61032,37253956
2019-05,Colorado,16653,10619,27272,5029196
2019-05,Connecticut,4655,1622,6277,3574097
2019-05,Delaware,1568,1028,2596,897934
2019-05,District of Columbia,142,4,146,601723
2019-05,Florida,45087,14214,59301,18801310
2019-05,Georgia,10988,5172,16160,9687653
2019-05,Idaho,3738,3728,7466,1567582
2019-05,Illinois,17976,7587,25563,12830632
2019-05,Indiana,15062,8146,23208,6483802
2019-05,Iowa,115,1471,1586,3046355
2019-05,Kansas,4466,3391,7857,2853118
2019-05,Kentucky,7899,4585,12484,4339367
2019-05,Louisiana,8327,5074,13401,4533372
2019-05,Maine,2886,2285,5171,1328361
2019-05,Maryland,3385,3645,7030,5773552
2019-05,Massachusetts,3759,2113,5872,6547629
2019-05,Michigan,9057,5984,15041,9883640
2019-05,Minnesota,8570,7754,16324,5303925
2019-05,Mississippi,6614,3553,10167,2967297
2019-05,Missouri,15869,10448,26317,5988927
2019-05,Montana,2747,3255,6002,989415
2019-05,Nebraska,67,1089,1156,1826341
2019-05,Nevada,4128,2161,6289,2700551
2019-05,New Hampshire,4079,2328,6407,1316470
2019-05,New Jersey,4791,2545,7336,8791894
2019-05,New Mexico,5564,3361,8925,2059179
2019-05,New York,8260,10090,18350,19378102
2019-05,North Carolina,1312,7798,9110,9535483
2019-05,North Dakota,1436,2033,3469,672591
2019-05,Ohio,17577,9758,27335,11536504
2019-05,Oklahoma,9704,6112,15816,3751351
2019-05,Oregon,12305,8465,20770,3831074
2019-05,Pennsylvania,38050,10807,48857,12702379
2019-05,Rhode Island,941,515,1456,1052567
2019-05,South Carolina,8332,3531,11863,4625364
2019-05,South Dakota,2148,2383,4531,814180
2019-05,Tennessee,20921,9885,30806,6346105
2019-05,Texas,38714,23587,62301,25145561
2019-05,Utah,3045,2849,5894,2763885
2019-05,Vermont,1333,1138,2471,625741
2019-05,Virginia,17935,8821,26756,8001024
2019-05,Washington,18141,11217,29358,6724540
2019-05,West Virginia,4787,3700,8487,1852994
2019-05,Wisconsin,11997,8512,20509,5686986
2019-05,Wyoming,1740,1828,3568,563626
2019-04,Alabama,6747,4538,11285,4779736
2019-04,Arizona,12985,6750,19735,6392017
2019-04,Arkansas,4951,4060,9011,2915918
2019-04,California,37484,25895,63379,37253956
2019-04,Colorado,17199,11594,28793,5029196
2019-04,Connecticut,4775,1792,6567,3574097
2019-04,Delaware,1687,1146,2833,897934
2019-04,District of Columbia,122,1,123,601723
2019-04,Florida,48329,15125,63454,18801310
2019-04,Georgia,12049,5798,17847,9687653
2019-04,Idaho,3865,4118,7983,1567582
2019-04,Illinois,21307,8748,30055,12830632
2019-04,Indiana,18528,9718,28246,6483802
2019-04,Iowa,200,1761,1961,3046355
2019-04,Kansas,4737,3858,8595,2853118
2019-04,Kentucky,10133,5989,16122,4339367
2019-04,Louisiana,9196,5330,14526,4533372
2019-04,Maine,3134,2819,5953,1328361
2019-04,Maryland,3759,4478,8237,5773552
2019-04,Massachusetts,3846,2280,6126,6547629
2019-04,Michigan,10368,7277,17645,9883640
2019-04,Minnesota,10655,11570,22225,5303925
2019-04,Mississippi,7199,3936,11135,2967297
2019-04,Missouri,15972,12020,27992,5988927
2019-04,Montana,2815,3704,6519,989415
2019-04,Nebraska,84,1318,1402,1826341
2019-04,Nevada,4502,2535,7037,2700551
2019-04,New Hampshire,4747,2873,7620,1316470
2019-04,New Jersey,4819,2982,7801,8791894
2019-04,New Mexico,5808,3936,9744,2059179
2019-04,New York,8971,12724,21695,19378102
2019-04,North Carolina,1487,8892,10379,9535483
2019-04,North Dakota,1743,2524,4267,672591
2019-04,Ohio,22541,11994,34535,11536504
2019-04,Oklahoma,10608,7199,17807,3751351
2019-04,Oregon,13360,9875,23235,3831074
2019-04,Pennsylvania,42418,12300,54718,12702379
2019-04,Rhode Island,995,742,1737,1052567
2019-04,South Carolina,9362,4050,13412,4625364
2019-04,South Dakota,2360,2870,5230,814180
2019-04,Tennessee,21848,10619,32467,6346105
2019-04,Texas,38994,24009,63003,25145561
2019-04,Utah,3365,3235,6600,2763885
2019-04,Vermont,1518,1485,3003,625741
2019-04,Virginia,20270,10699,30969,8001024
2019-04,Washington,17631,10844,28475,6724540
2019-04,West Virginia,5819,4822,10641,1852994
2019-04,Wisconsin,14617,12535,27152,5686986
2019-04,Wyoming,1888,1906,3794,563626
2019-03,Alabama,9991,6439,16430,4779736
2019-03,Arizona,15993,8497,24490,6392017
2019-03,Arkansas,7948,5821,13769,2915918
2019-03,California,42551,28146,70697,37253956
2019-03,Colorado,22511,13791,36302,5029196
2019-03,Connecticut,6189,2344,8533,3574097
2019-03,Delaware,2407,1377,3784,897934
2019-03,District of Columbia,112,5,117,601723
2019-03,Florida,59615,19429,79044,18801310
2019-03,Georgia,19228,9131,28359,9687653
2019-03,Idaho,5362,5161,10523,1567582
2019-03,Illinois,29438,13143,42581,12830632
2019-03,Indiana,26630,13737,40367,6483802
2019-03,Iowa,204,3014,3218,3046355
2019-03,Kansas,7807,5590,13397,2853118
2019-03,Kentucky,15646,8110,23756,4339367
2019-03,Louisiana,13050,7148,20198,4533372
2019-03,Maine,4191,2992,7183,1328361
2019-03,Maryland,4288,6080,10368,5773552
2019-03,Massachusetts,5079,3151,8230,6547629
2019-03,Michigan,15403,10260,25663,9883640
2019-03,Minnesota,12098,11981,24079,5303925
2019-03,Mississippi,11180,6116,17296,2967297
2019-03,Missouri,23939,17749,41688,5988927
2019-03,Montana,3703,4218,7921,989415
2019-03,Nebraska,146,1913,2059,1826341
2019-03,Nevada,6661,3114,9775,2700551
2019-03,New Hampshire,6297,3374,9671,1316470
2019-03,New Jersey,4579,3446,8025,8791894
2019-03,New Mexico,8137,5252,13389,2059179
2019-03,New York,10834,14996,25830,19378102
2019-03,North Carolina,1931,12758,14689,9535483
2019-03,North Dakota,2191,2783,4974,672591
2019-03,Ohio,31090,17313,48403,11536504
2019-03,Oklahoma,15423,9896,25319,3751351
2019-03,Oregon,17208,12161,29369,3831074
2019-03,Pennsylvania,60068,16921,76989,12702379
2019-03,Rhode Island,1201,858,2059,1052567
2019-03,South Carolina,13957,6268,20225,4625364
2019-03,South Dakota,3274,3450,6724,814180
2019-03,Tennessee,30728,15086,45814,6346105
2019-03,Texas,55222,31747,86969,25145561
2019-03,Utah,4876,4081,8957,2763885
2019-03,Vermont,2043,1693,3736,625741
2019-03,Virginia,29043,14550,43593,8001024
2019-03,Washington,21158,13211,34369,6724540
2019-03,West Virginia,8633,6778,15411,1852994
2019-03,Wisconsin,19952,15240,35192,5686986
2019-03,Wyoming,2497,2314,4811,563626
2019-02,Alabama,8278,5353,13631,4779736
2019-02,Arizona,13933,7135,21068,6392017
2019-02,Arkansas,7144,5251,12395,2915918
2019-02,California,36424,22506,58930,37253956
2019-02,Colorado,18697,11731,30428,5029196
2019-02,Connecticut,5459,1818,7277,3574097
2019-02,Delaware,1698,1208,2906,897934
2019-02,District of Columbia,88,4,92,601723
2019-02,Florida,51711,17833,69544,18801310
2019-02,Georgia,16172,7742,23914,9687653
2019-02,Idaho,3887,3548,7435,1567582
2019-02,Illinois,24870,11381,36251,12830632
2019-02,Indiana,21297,11157,32454,6483802
2019-02,Iowa,153,1935,2088,3046355
2019-02,Kansas,6271,4688,10959,2853118
2019-02,Kentucky,12027,7182,19209,4339367
2019-02,Louisiana,11056,6849,17905,4533372
2019-02,Maine,2989,2352,5341,1328361
2019-02,Maryland,3822,4613,8435,5773552
2019-02,Massachusetts,4359,2428,6787,6547629
2019-02,Michigan,11272,7497,18769,9883640
2019-02,Minnesota,7938,7215,15153,5303925
2019-02,Mississippi,9790,5717,15507,2967297
2019-02,Missouri,19884,13773,33657,5988927
2019-02,Montana,2391,2730,5121,989415
2019-02,Nebraska,122,1428,1550,1826341
2019-02,Nevada,5541,2524,8065,2700551
2019-02,New Hampshire,5793,2713,8506,1316470
2019-02,New Jersey,3794,2949,6743,8791894
2019-02,New Mexico,6890,4371,11261,2059179
2019-02,New York,8914,11566,20480,19378102
2019-02,North Carolina,1620,11335,12955,9535483
2019-02,North Dakota,1514,1981,3495,672591
2019-02,Ohio,25652,13985,39637,11536504
2019-02,Oklahoma,13014,8165,21179,3751351
2019-02,Oregon,14214,9428,23642,3831074
2019-02,Pennsylvania,47570,13297,60867,12702379
2019-02,Rhode Island,1043,624,1667,1052567
2019-02,South Carolina,12375,5724,18099,4625364
2019-02,South Dakota,2701,2790,5491,814180
2019-02,Tennessee,27213,14058,41271,6346105
2019-02,Texas,49130,28709,77839,25145561
2019-02,Utah,3463,3018,6481,2763885
2019-02,Vermont,1545,1373,2918,625741
2019-02,Virginia,24579,12572,37151,8001024
2019-02,Washington,15775,10106,25881,6724540
2019-02,West Virginia,7011,5575,12586,1852994
2019-02,Wisconsin,13838,9899,23737,5686986
2019-02,Wyoming,1900,1791,3691,563626
2019-01,Alabama,6671,5507,12178,4779736
2019-01,Arizona,11710,6865,18575,6392017
2019-01,Arkansas,5108,5175,10283,2915918
2019-01,California,35861,23195,59056,37253956
2019-01,Colorado,16417,11575,27992,5029196
2019-01,Connecticut,5368,1945,7313,3574097
2019-01,Delaware,1684,1473,3157,897934
2019-01,District of Columbia,101,5,106,601723
2019-01,Florida,47372,18749,66121,18801310
2019-01,Georgia,11780,7535,19315,9687653
2019-01,Idaho,3522,3602,7124,1567582
2019-01,Illinois,21587,10082,31669,12830632
2019-01,Indiana,17265,10423,27688,6483802
2019-01,Iowa,128,1887,2015,3046355
2019-01,Kansas,5269,4584,9853,2853118
2019-01,Kentucky,8170,6213,14383,4339367
2019-01,Louisiana,8961,7473,16434,4533372
2019-01,Maine,2652,2333,4985,1328361
2019-01,Maryland,4254,4473,8727,5773552
2019-01,Massachusetts,4016,2644,6660,6547629
2019-01,Michigan,8674,6844,15518,9883640
2019-01,Minnesota,8031,7106,15137,5303925
2019-01,Mississippi,6833,5707,12540,2967297
2019-01,Missouri,16244,12657,28901,5988927
2019-01,Montana,2097,2753,4850,989415
2019-01,Nebraska,125,1711,1836,1826341
2019-01,Nevada,5001,2386,7387,2700551
2019-01,New Hampshire,4672,2529,7201,1316470
2019-01,New Jersey,3508,3084,6592,8791894
2019-01,New Mexico,4987,3778,8765,2059179
2019-01,New York,9271,11257,20528,19378102
2019-01,North Carolina,1409,10951,12360,9535483
2019-01,North Dakota,1425,2015,3440,672591
2019-01,Ohio,19573,12290,31863,11536504
2019-01,Oklahoma,10411,8202,18613,3751351
2019-01,Oregon,13630,9117,22747,3831074
2019-01,Pennsylvania,40144,11833,51977,12702379
2019-01,Rhode Island,1054,662,1716,1052567
2019-01,South Carolina,9696,5459,15155,4625364
2019-01,South Dakota,2154,2808,4962,814180
2019-01,Tennessee,22848,13776,36624,6346105
2019-01,Texas,39240,27842,67082,25145561
2019-01,Utah,3017,2834,5851,2763885
2019-01,Vermont,1124,1092,2216,625741
2019-01,Virginia,20600,12813,33413,8001024
2019-01,Washington,17487,10889,28376,6724540
2019-01,West Virginia,5355,4964,10319,1852994
2019-01,Wisconsin,12204,9154,21358,5686986
2019-01,Wyoming,1530,1621,3151,563626
2018-12,Alabama,11463,13578,25041,4779736
2018-12,Arizona,15533,11436,26969,6392017
2018-12,Arkansas,8138,11736,19874,2915918
2018-12,California,40445,34180,74625,37253956
2018-12,Colorado,22627,18734,41361,5029196
2018-12,Connecticut,5904,2506,8410,3574097
2018-12,Delaware,1932,2503,4435,897934
2018-12,District of Columbia,71,4,75,601723
2018-12,Florida,60210,30598,90808,18801310
2018-12,Georgia,19241,18475,37716,9687653
2018-12,Idaho,5667,6949,12616,1567582
2018-12,Illinois,26943,15297,42240,12830632
2018-12,Indiana,24824,18824,43648,6483802
2018-12,Iowa,262,4392,4654,3046355
2018-12,Kansas,7418,8702,16120,2853118
2018-12,Kentucky,14189,14309,28498,4339367
2018-12,Louisiana,13856,17376,31232,4533372
2018-12,Maine,3783,4282,8065,1328361
2018-12,Maryland,4500,7309,11809,5773552
2018-12,Massachusetts,4492,3178,7670,6547629
2018-12,Michigan,12897,13972,26869,9883640
2018-12,Minnesota,9144,11057,20201,5303925
2018-12,Mississippi,11557,14731,26288,2967297
2018-12,Missouri,24730,23584,48314,5988927
2018-12,Montana,3744,5291,9035,989415
2018-12,Nebraska,160,3331,3491,1826341
2018-12,Nevada,5889,3993,9882,2700551
2018-12,New Hampshire,5845,3977,9822,1316470
2018-12,New Jersey,3432,4099,7531,8791894
2018-12,New Mexico,6858,6580,13438,2059179
2018-12,New York,9675,19234,28909,19378102
2018-12,North Carolina,2367,22327,24694,9535483
2018-12,North Dakota,1853,3144,4997,672591
2018-12,Ohio,30746,25012,55758,11536504
2018-12,Oklahoma,15708,16053,31761,3751351
2018-12,Oregon,16985,14374,31359,3831074
2018-12,Pennsylvania,54857,20732,75589,12702379
2018-12,Rhode Island,1069,770,1839,1052567
2018-12,South Carolina,13465,11856,25321,4625364
2018-12,South Dakota,2913,4497,7410,814180
2018-12,Tennessee,34499,26987,61486,6346105
2018-12,Texas,62560,56919,119479,25145561
2018-12,Utah,5369,7214,12583,2763885
2018-12,Vermont,1620,1871,3491,625741
2018-12,Virginia,26129,22048,48177,8001024
2018-12,Washington,23131,20690,43821,6724540
2018-12,West Virginia,9693,10824,20517,1852994
2018-12,Wisconsin,16181,14362,30543,5686986
2018-12,Wyoming,2653,3033,5686,563626
2018-11,Alabama,8408,10303,18711,4779736
2018-11,Arizona,12412,8886,21298,6392017
2018-11,Arkansas,5739,10196,15935,2915918
2018-11,California,36997,30913,67910,37253956
2018-11,Colorado,18926,15702,34628,5029196
2018-11,Connecticut,5078,2331,7409,3574097
2018-11,Delaware,1578,2082,3660,897934
2018-11,District of Columbia,80,3,83,601723
2018-11,Florida,51850,23876,75726,18801310
2018-11,Georgia,13770,13749,27519,9687653
2018-11,Idaho,4077,5851,9928,1567582
2018-11,Illinois,22978,14038,37016,12830632
2018-11,Indiana,20522,18723,39245,6483802
2018-11,Iowa,303,4319,4622,3046355
2018-11,Kansas,5885,7334,13219,2853118
2018-11,Kentucky,10506,12670,23176,4339367
2018-11,Louisiana,10242,14336,24578,4533372
2018-11,Maine,2661,3768,6429,1328361
2018-11,Maryland,3979,7150,11129,5773552
2018-11,Massachusetts,4334,3194,7528,6547629
2018-11,Michigan,11474,17534,29008,9883640
2018-11,Minnesota,6691,10900,17591,5303925
2018-11,Mississippi,7650,11816,19466,2967297
2018-11,Missouri,19158,21908,41066,5988927
2018-11,Montana,2727,4603,7330,989415
2018-11,Nebraska,198,2964,3162,1826341
2018-11,Nevada,4806,3132,7938,2700551
2018-11,New Hampshire,5051,3514,8565,1316470
2018-11,New Jersey,3297,3769,7066,8791894
2018-11,New Mexico,5731,5331,11062,2059179
2018-11,New York,8290,18315,26605,19378102
2018-11,North Carolina,2159,18381,20540,9535483
2018-11,North Dakota,1655,3274,4929,672591
2018-11,Ohio,25372,26274,51646,11536504
2018-11,Oklahoma,12669,14074,26743,3751351
2018-11,Oregon,14426,12344,26770,3831074
2018-11,Pennsylvania,49328,20463,69791,12702379
2018-11,Rhode Island,1020,727,1747,1052567
2018-11,South Carolina,10229,9329,19558,4625364
2018-11,South Dakota,2637,4907,7544,814180
2018-11,Tennessee,27015,22267,49282,6346105
2018-11,Texas,44763,43276,88039,25145561
2018-11,Utah,3989,5599,9588,2763885
2018-11,Vermont,1094,1690,2784,625741
2018-11,Virginia,22204,19747,41951,8001024
2018-11,Washington,20113,19136,39249,6724540
2018-11,West Virginia,6450,10648,17098,1852994
2018-11,Wisconsin,14769,17342,32111,5686986
2018-11,Wyoming,1933,2532,4465,563626
2018-10,Alabama,5218,5918,11136,4779736
2018-10,Arizona,9886,6427,16313,6392017
2018-10,Arkansas,4312,6792,11104,2915918
2018-10,California,32567,23213,55780,37253956
2018-10,Colorado,15101,13079,28180,5029196
2018-10,Connecticut,4575,1979,6554,3574097
2018-10,Delaware,1420,1512,2932,897934
2018-10,District of Columbia,81,5,86,601723
2018-10,Florida,40226,16671,56897,18801310
2018-10,Georgia,10007,8856,18863,9687653
2018-10,Idaho,3034,5025,8059,1567582
2018-10,Illinois,17916,10755,28671,12830632
2018-10,Indiana,15032,12352,27384,6483802
2018-10,Iowa,173,2700,2873,3046355
2018-10,Kansas,4223,4884,9107,2853118
2018-10,Kentucky,7065,8001,15066,4339367
2018-10,Louisiana,8073,10567,18640,4533372
2018-10,Maine,2565,5428,7993,1328361
2018-10,Maryland,4020,5112,9132,5773552
2018-10,Massachusetts,3750,2632,6382,6547629
2018-10,Michigan,8259,11649,19908,9883640
2018-10,Minnesota,5041,14232,19273,5303925
2018-10,Mississippi,6049,6638,12687,2967297
2018-10,Missouri,15963,17163,33126,5988927
2018-10,Montana,2293,5246,7539,989415
2018-10,Nebraska,119,2172,2291,1826341
2018-10,Nevada,3731,2051,5782,2700551
2018-10,New Hampshire,4238,3494,7732,1316470
2018-10,New Jersey,3710,2806,6516,8791894
2018-10,New Mexico,4655,3993,8648,2059179
2018-10,New York,8258,16163,24421,19378102
2018-10,North Carolina,1392,12065,13457,9535483
2018-10,North Dakota,1487,3700,5187,672591
2018-10,Ohio,18401,15830,34231,11536504
2018-10,Oklahoma,8849,8803,17652,3751351
2018-10,Oregon,11776,10088,21864,3831074
2018-10,Pennsylvania,41412,14583,55995,12702379
2018-10,Rhode Island,947,646,1593,1052567
2018-10,South Carolina,7002,6023,13025,4625364
2018-10,South Dakota,1882,5208,7090,814180
2018-10,Tennessee,20286,13725,34011,6346105
2018-10,Texas,34646,31100,65746,25145561
2018-10,Utah,2615,3619,6234,2763885
2018-10,Vermont,1100,1948,3048,625741
2018-10,Virginia,17662,13511,31173,8001024
2018-10,Washington,14925,11932,26857,6724540
2018-10,West Virginia,5250,6998,12248,1852994
2018-10,Wisconsin,11766,14833,26599,5686986
2018-10,Wyoming,1442,2172,3614,563626
2018-09,Alabama,4978,5832,10810,4779736
2018-09,Arizona,10298,6638,16936,6392017
2018-09,Arkansas,3987,5257,9244,2915918
2018-09,California,29772,23788,53560,37253956
2018-09,Colorado,14546,12061,26607,5029196
2018-09,Connecticut,4151,1782,5933,3574097
2018-09,Delaware,1187,1225,2412,897934
2018-09,District of Columbia,78,4,82,601723
2018-09,Florida,38313,14646,52959,18801310
2018-09,Georgia,10387,7060,17447,9687653
2018-09,Idaho,3217,4776,7993,1567582
2018-09,Illinois,16749,9393,26142,12830632
2018-09,Indiana,13687,10201,23888,6483802
2018-09,Iowa,132,2391,2523,3046355
2018-09,Kansas,4043,4326,8369,2853118
2018-09,Kentucky,6603,6014,12617,4339367
2018-09,Louisiana,8654,9546,18200,4533372
2018-09,Maine,2678,4102,6780,1328361
2018-09,Maryland,3413,4397,7810,5773552
2018-09,Massachusetts,3518,2407,5925,6547629
2018-09,Michigan,7630,9887,17517,9883640
2018-09,Minnesota,3801,10997,14798,5303925
2018-09,Mississippi,6470,6042,12512,2967297
2018-09,Missouri,15226,12816,28042,5988927
2018-09,Montana,2326,4565,6891,989415
2018-09,Nebraska,83,1547,1630,1826341
2018-09,Nevada,3714,2111,5825,2700551
2018-09,New Hampshire,4150,3161,7311,1316470
2018-09,New Jersey,3511,2480,5991,8791894
2018-09,New Mexico,4596,3985,8581,2059179
2018-09,New York,7755,15014,22769,19378102
2018-09,North Carolina,958,8836,9794,9535483
2018-09,North Dakota,1336,3135,4471,672591
2018-09,Ohio,17460,13312,30772,11536504
2018-09,Oklahoma,8158,7776,15934,3751351
2018-09,Oregon,11763,10604,22367,3831074
2018-09,Pennsylvania,36793,12563,49356,12702379
2018-09,Rhode Island,738,562,1300,1052567
2018-09,South Carolina,6680,4748,11428,4625364
2018-09,South Dakota,1975,3564,5539,814180
2018-09,Tennessee,18721,11942,30663,6346105
2018-09,Texas,33746,33087,66833,25145561
2018-09,Utah,2678,3400,6078,2763885
2018-09,Vermont,1486,1853,3339,625741
2018-09,Virginia,16923,12040,28963,8001024
2018-09,Washington,13517,11021,24538,6724540
2018-09,West Virginia,4914,5918,10832,1852994
2018-09,Wisconsin,11254,12707,23961,5686986
2018-09,Wyoming,1545,2235,3780,563626
2018-08,Alabama,5991,5741,11732,4779736
2018-08,Arizona,10833,6987,17820,6392017
2018-08,Arkansas,4809,5590,10399,2915918
2018-08,California,34617,25666,60283,37253956
2018-08,Colorado,16160,12392,28552,5029196
2018-08,Connecticut,4519,1690,6209,3574097
2018-08,Delaware,1262,1162,2424,897934
2018-08,District of Columbia,91,1,92,601723
2018-08,Florida,44227,15734,59961,18801310
2018-08,Georgia,10894,7419,18313,9687653
2018-08,Idaho,3374,3899,7273,1567582
2018-08,Illinois,17992,9858,27850,12830632
2018-08,Indiana,15764,10339,26103,6483802
2018-08,Iowa,160,1935,2095,3046355
2018-08,Kansas,4500,4505,9005,2853118
2018-08,Kentucky,7250,6241,13491,4339367
2018-08,Louisiana,9103,8745,17848,4533372
2018-08,Maine,2835,2946,5781,1328361
2018-08,Maryland,4148,4001,8149,5773552
2018-08,Massachusetts,4322,2396,6718,6547629
2018-08,Michigan,8110,7973,16083,9883640
2018-08,Minnesota,3773,8142,11915,5303925
2018-08,Mississippi,7489,6695,14184,2967297
2018-08,Missouri,16706,13657,30363,5988927
2018-08,Montana,2617,3805,6422,989415
2018-08,Nebraska,95,1493,1588,1826341
2018-08,Nevada,4164,2137,6301,2700551
2018-08,New Hampshire,4382,2960,7342,1316470
2018-08,New Jersey,4069,2968,7037,8791894
2018-08,New Mexico,5303,4077,9380,2059179
2018-08,New York,8314,11362,19676,19378102
2018-08,North Carolina,1180,10190,11370,9535483
2018-08,North Dakota,1284,2475,3759,672591
2018-08,Ohio,18482,12449,30931,11536504
2018-08,Oklahoma,9823,8558,18381,3751351
2018-08,Oregon,11938,8751,20689,3831074
2018-08,Pennsylvania,38142,11911,50053,12702379
2018-08,Rhode Island,911,589,1500,1052567
2018-08,South Carolina,8135,5763,13898,4625364
2018-08,South Dakota,2012,3041,5053,814180
2018-08,Tennessee,20996,13165,34161,6346105
2018-08,Texas,37819,35212,73031,25145561
2018-08,Utah,2650,2996,5646,2763885
2018-08,Vermont,1336,1251,2587,625741
2018-08,Virginia,18729,11694,30423,8001024
2018-08,Washington,14615,9761,24376,6724540
2018-08,West Virginia,4986,4987,9973,1852994
2018-08,Wisconsin,11118,10987,22105,5686986
2018-08,Wyoming,1570,2059,3629,563626
2018-07,Alabama,5110,4540,9650,4779736
2018-07,Arizona,10166,5848,16014,6392017
2018-07,Arkansas,4245,3625,7870,2915918
2018-07,California,30486,21136,51622,37253956
2018-07,Colorado,15420,10239,25659,5029196
2018-07,Connecticut,4379,1611,5990,3574097
2018-07,Delaware,1314,950,2264,897934
2018-07,District of Columbia,88,2,90,601723
2018-07,Florida,42524,13468,55992,18801310
2018-07,Georgia,9759,5232,14991,9687653
2018-07,Idaho,3202,3160,6362,1567582
2018-07,Illinois,16840,7743,24583,12830632
2018-07,Indiana,13914,7825,21739,6483802
2018-07,Iowa,76,1469,1545,3046355
2018-07,Kansas,4579,3410,7989,2853118
2018-07,Kentucky,6306,4537,10843,4339367
2018-07,Louisiana,8596,6115,14711,4533372
2018-07,Maine,2542,2294,4836,1328361
2018-07,Maryland,3730,3398,7128,5773552
2018-07,Massachusetts,3380,1997,5377,6547629
2018-07,Michigan,7846,6018,13864,9883640
2018-07,Minnesota,3275,5135,8410,5303925
2018-07,Mississippi,5884,3568,9452,2967297
2018-07,Missouri,14330,10470,24800,5988927
2018-07,Montana,2421,2865,5286,989415
2018-07,Nebraska,91,1090,1181,1826341
2018-07,Nevada,3678,1799,5477,2700551
2018-07,New Hampshire,4157,2332,6489,1316470
2018-07,New Jersey,4193,2486,6679,8791894
2018-07,New Mexico,4795,3252,8047,2059179
2018-07,New York,7901,8692,16593,19378102
2018-07,North Carolina,1145,7771,8916,9535483
2018-07,North Dakota,1079,1791,2870,672591
2018-07,Ohio,16942,10255,27197,11536504
2018-07,Oklahoma,8920,6314,15234,3751351
2018-07,Oregon,10543,7700,18243,3831074
2018-07,Pennsylvania,33494,9738,43232,12702379
2018-07,Rhode Island,799,453,1252,1052567
2018-07,South Carolina,6972,4037,11009,4625364
2018-07,South Dakota,1678,2160,3838,814180
2018-07,Tennessee,19188,9840,29028,6346105
2018-07,Texas,35363,23141,58504,25145561
2018-07,Utah,2603,2497,5100,2763885
2018-07,Vermont,1156,999,2155,625741
2018-07,Virginia,18547,10039,28586,8001024
2018-07,Washington,13547,8385,21932,6724540
2018-07,West Virginia,4473,3951,8424,1852994
2018-07,Wisconsin,9351,7471,16822,5686986
2018-07,Wyoming,1448,1559,3007,563626
2018-06,Alabama,5868,4646,10514,4779736
2018-06,Arizona,10785,5965,16750,6392017
2018-06,Arkansas,4478,3528,8006,2915918
2018-06,California,32684,23612,56296,37253956
2018-06,Colorado,15796,10351,26147,5029196
2018-06,Connecticut,4725,1673,6398,3574097
2018-06,Delaware,1412,1019,2431,897934
2018-06,District of Columbia,79,3,82,601723
2018-06,Florida,44821,14764,59585,18801310
2018-06,Georgia,11269,5571,16840,9687653
2018-06,Idaho,3609,3734,7343,1567582
2018-06,Illinois,17755,7827,25582,12830632
2018-06,Indiana,15459,8455,23914,6483802
2018-06,Iowa,92,1415,1507,3046355
2018-06,Kansas,4344,3247,7591,2853118
2018-06,Kentucky,7130,4686,11816,4339367
2018-06,Louisiana,9703,5683,15386,4533372
2018-06,Maine,2655,2342,4997,1328361
2018-06,Maryland,4095,3608,7703,5773552
2018-06,Massachusetts,3996,2249,6245,6547629
2018-06,Michigan,8369,6096,14465,9883640
2018-06,Minnesota,3603,5075,8678,5303925
2018-06,Mississippi,6446,3594,10040,2967297
2018-06,Missouri,15679,10488,26167,5988927
2018-06,Montana,2592,3377,5969,989415
2018-06,Nebraska,103,1089,1192,1826341
2018-06,Nevada,4117,2112,6229,2700551
2018-06,New Hampshire,4430,2542,6972,1316470
2018-06,New Jersey,4609,2626,7235,8791894
2018-06,New Mexico,5109,3363,8472,2059179
2018-06,New York,8745,9688,18433,19378102
2018-06,North Carolina,1348,8100,9448,9535483
2018-06,North Dakota,1248,1778,3026,672591
2018-06,Ohio,17338,10649,27987,11536504
2018-06,Oklahoma,10295,6449,16744,3751351
2018-06,Oregon,12700,8659,21359,3831074
2018-06,Pennsylvania,37280,10817,48097,12702379
2018-06,Rhode Island,834,582,1416,1052567
2018-06,South Carolina,7950,3967,11917,4625364
2018-06,South Dakota,1880,2313,4193,814180
2018-06,Tennessee,20805,10399,31204,6346105
2018-06,Texas,39032,24252,63284,25145561
2018-06,Utah,2941,2704,5645,2763885
2018-06,Vermont,1347,1181,2528,625741
2018-06,Virginia,17812,9865,27677,8001024
2018-06,Washington,15069,9423,24492,6724540
2018-06,West Virginia,4988,4109,9097,1852994
2018-06,Wisconsin,9993,7627,17620,5686986
2018-06,Wyoming,1633,1660,3293,563626
2018-05,Alabama,5784,5039,10823,4779736
2018-05,Arizona,11194,6241,17435,6392017
2018-05,Arkansas,4355,3442,7797,2915918
2018-05,California,34433,24797,59230,37253956
2018-05,Colorado,16113,11143,27256,5029196
2018-05,Connecticut,4454,1775,6229,3574097
2018-05,Delaware,1422,1107,2529,897934
2018-05,District of Columbia,88,2,90,601723
2018-05,Florida,47755,15850,63605,18801310
2018-05,Georgia,11159,5669,16828,9687653
2018-05,Idaho,3387,3812,7199,1567582
2018-05,Illinois,18631,8397,27028,12830632
2018-05,Indiana,15856,8256,24112,6483802
2018-05,Iowa,95,1507,1602,3046355
2018-05,Kansas,4305,3307,7612,2853118
2018-05,Kentucky,7620,4696,12316,4339367
2018-05,Louisiana,9039,5435,14474,4533372
2018-05,Maine,2978,2362,5340,1328361
2018-05,Maryland,4503,3961,8464,5773552
2018-05,Massachusetts,4167,2351,6518,6547629
2018-05,Michigan,8598,6049,14647,9883640
2018-05,Minnesota,4034,5435,9469,5303925
2018-05,Mississippi,6653,3624,10277,2967297
2018-05,Missouri,15576,10536,26112,5988927
2018-05,Montana,2557,3578,6135,989415
2018-05,Nebraska,111,1139,1250,1826341
2018-05,Nevada,4185,2209,6394,2700551
2018-05,New Hampshire,4707,2524,7231,1316470
2018-05,New Jersey,4983,2810,7793,8791894
2018-05,New Mexico,5296,3355,8651,2059179
2018-05,New York,8916,10491,19407,19378102
2018-05,North Carolina,1322,8298,9620,9535483
2018-05,North Dakota,1327,1829,3156,672591
2018-05,Ohio,18830,10891,29721,11536504
2018-05,Oklahoma,9964,6610,16574,3751351
2018-05,Oregon,13221,9111,22332,3831074
2018-05,Pennsylvania,39765,10670,50435,12702379
2018-05,Rhode Island,977,610,1587,1052567
2018-05,South Carolina,7883,3855,11738,4625364
2018-05,South Dakota,1874,2351,4225,814180
2018-05,Tennessee,20549,10028,30577,6346105
2018-05,Texas,37893,24419,62312,25145561
2018-05,Utah,3202,3025,6227,2763885
2018-05,Vermont,1322,1241,2563,625741
2018-05,Virginia,18493,9958,28451,8001024
2018-05,Washington,15131,9417,24548,6724540
2018-05,West Virginia,5258,4037,9295,1852994
2018-05,Wisconsin,10738,8239,18977,5686986
2018-05,Wyoming,1734,1813,3547,563626
2018-04,Alabama,6405,5267,11672,4779736
2018-04,Arizona,12889,7176,20065,6392017
2018-04,Arkansas,5129,4326,9455,2915918
2018-04,California,37814,25571,63385,37253956
2018-04,Colorado,19015,13280,32295,5029196
2018-04,Connecticut,4977,2151,7128,3574097
2018-04,Delaware,1767,1697,3464,897934
2018-04,District of Columbia,92,4,96,601723
2018-04,Florida,50172,18650,68822,18801310
2018-04,Georgia,12238,6549,18787,9687653
2018-04,Idaho,3843,4182,8025,1567582
2018-04,Illinois,23977,10883,34860,12830632
2018-04,Indiana,19405,11491,30896,6483802
2018-04,Iowa,156,2140,2296,3046355
2018-04,Kansas,5457,4530,9987,2853118
2018-04,Kentucky,8893,6662,15555,4339367
2018-04,Louisiana,9937,6304,16241,4533372
2018-04,Maine,3572,3580,7152,1328361
2018-04,Maryland,4867,5181,10048,5773552
2018-04,Massachusetts,4619,2967,7586,6547629
2018-04,Michigan,11288,8635,19923,9883640
2018-04,Minnesota,6258,9688,15946,5303925
2018-04,Mississippi,7561,4186,11747,2967297
2018-04,Missouri,18537,13868,32405,5988927
2018-04,Montana,2745,4018,6763,989415
2018-04,Nebraska,111,1478,1589,1826341
2018-04,Nevada,4424,2689,7113,2700551
2018-04,New Hampshire,5647,3465,9112,1316470
2018-04,New Jersey,5170,3549,8719,8791894
2018-04,New Mexico,5857,4163,10020,2059179
2018-04,New York,10068,14667,24735,19378102
2018-04,North Carolina,1340,10138,11478,9535483
2018-04,North Dakota,1824,2622,4446,672591
2018-04,Ohio,25111,15459,40570,11536504
2018-04,Oklahoma,11599,8386,19985,3751351
2018-04,Oregon,15089,11283,26372,3831074
2018-04,Pennsylvania,47093,13434,60527,12702379
2018-04,Rhode Island,1131,773,1904,1052567
2018-04,South Carolina,8977,4681,13658,4625364
2018-04,South Dakota,2403,2994,5397,814180
2018-04,Tennessee,23325,12360,35685,6346105
2018-04,Texas,41373,27019,68392,25145561
2018-04,Utah,3667,3460,7127,2763885
2018-04,Vermont,2261,2290,4551,625741
2018-04,Virginia,20638,12759,33397,8001024
2018-04,Washington,17123,11153,28276,6724540
2018-04,West Virginia,6251,5479,11730,1852994
2018-04,Wisconsin,14507,13478,27985,5686986
2018-04,Wyoming,1846,1929,3775,563626
2018-03,Alabama,10050,7695,17745,4779736
2018-03,Arizona,16991,10611,27602,6392017
2018-03,Arkansas,8523,7017,15540,2915918
2018-03,California,47425,32189,79614,37253956
2018-03,Colorado,24811,17741,42552,5029196
2018-03,Connecticut,6906,2977,9883,3574097
2018-03,Delaware,2385,2282,4667,897934
2018-03,District of Columbia,93,3,96,601723
2018-03,Florida,64230,30487,94717,18801310
2018-03,Georgia,19849,10901,30750,9687653
2018-03,Idaho,5386,5788,11174,1567582
2018-03,Illinois,32326,17008,49334,12830632
2018-03,Indiana,28224,16982,45206,6483802
2018-03,Iowa,177,3585,3762,3046355
2018-03,Kansas,8400,6921,15321,2853118
2018-03,Kentucky,14642,10303,24945,4339367
2018-03,Louisiana,13831,8906,22737,4533372
2018-03,Maine,4640,3947,8587,1328361
2018-03,Maryland,6360,7182,13542,5773552
2018-03,Massachusetts,6636,3974,10610,6547629
2018-03,Michigan,17166,12721,29887,9883640
2018-03,Minnesota,7583,11538,19121,5303925
2018-03,Mississippi,12054,7132,19186,2967297
2018-03,Missouri,27559,21245,48804,5988927
2018-03,Montana,3992,5369,9361,989415
2018-03,Nebraska,162,2411,2573,1826341
2018-03,Nevada,6427,3625,10052,2700551
2018-03,New Hampshire,7132,4245,11377,1316470
2018-03,New Jersey,5178,4758,9936,8791894
2018-03,New Mexico,8110,6046,14156,2059179
2018-03,New York,11578,17006,28584,19378102
2018-03,North Carolina,1808,16114,17922,9535483
2018-03,North Dakota,2195,3201,5396,672591
2018-03,Ohio,36314,24477,60791,11536504
2018-03,Oklahoma,15682,12018,27700,3751351
2018-03,Oregon,19409,15464,34873,3831074
2018-03,Pennsylvania,67756,19867,87623,12702379
2018-03,Rhode Island,1544,1261,2805,1052567
2018-03,South Carolina,13772,7673,21445,4625364
2018-03,South Dakota,3523,4408,7931,814180
2018-03,Tennessee,32501,19418,51919,6346105
2018-03,Texas,60134,38853,98987,25145561
2018-03,Utah,5277,5296,10573,2763885
2018-03,Vermont,2818,2713,5531,625741
2018-03,Virginia,30568,19180,49748,8001024
2018-03,Washington,22041,15774,37815,6724540
2018-03,West Virginia,9955,8325,18280,1852994
2018-03,Wisconsin,19901,18290,38191,5686986
2018-03,Wyoming,2502,2536,5038,563626
2018-02,Alabama,9220,7172,16392,4779736
2018-02,Arizona,14966,9058,24024,6392017
2018-02,Arkansas,7671,6405,14076,2915918
2018-02,California,38531,24768,63299,37253956
2018-02,Colorado,20604,13985,34589,5029196
2018-02,Connecticut,5918,2269,8187,3574097
2018-02,Delaware,1852,1579,3431,897934
2018-02,District of Columbia,62,3,65,601723
2018-02,Florida,57435,26441,83876,18801310
2018-02,Georgia,17618,9410,27028,9687653
2018-02,Idaho,4196,4300,8496,1567582
2018-02,Illinois,25626,12938,38564,12830632
2018-02,Indiana,24019,13516,37535,6483802
2018-02,Iowa,156,2587,2743,3046355
2018-02,Kansas,7467,5818,13285,2853118
2018-02,Kentucky,13917,9302,23219,4339367
2018-02,Louisiana,11907,7865,19772,4533372
2018-02,Maine,3556,2797,6353,1328361
2018-02,Maryland,4424,5496,9920,5773552
2018-02,Massachusetts,5271,3035,8306,6547629
2018-02,Michigan,12934,9602,22536,9883640
2018-02,Minnesota,5034,7148,12182,5303925
2018-02,Mississippi,11031,6516,17547,2967297
2018-02,Missouri,23601,17167,40768,5988927
2018-02,Montana,2834,3401,6235,989415
2018-02,Nebraska,122,1973,2095,1826341
2018-02,Nevada,5510,2898,8408,2700551
2018-02,New Hampshire,5778,3076,8854,1316470
2018-02,New Jersey,4613,3646,8259,8791894
2018-02,New Mexico,7244,4985,12229,2059179
2018-02,New York,10345,13742,24087,19378102
2018-02,North Carolina,1642,13498,15140,9535483
2018-02,North Dakota,1713,2220,3933,672591
2018-02,Ohio,30691,19698,50389,11536504
2018-02,Oklahoma,13836,10146,23982,3751351
2018-02,Oregon,15672,11370,27042,3831074
2018-02,Pennsylvania,51425,14849,66274,12702379
2018-02,Rhode Island,1272,886,2158,1052567
2018-02,South Carolina,12843,6512,19355,4625364
2018-02,South Dakota,2844,3476,6320,814180
2018-02,Tennessee,31159,16929,48088,6346105
2018-02,Texas,55634,35889,91523,25145561
2018-02,Utah,4175,4055,8230,2763885
2018-02,Vermont,1876,1708,3584,625741
2018-02,Virginia,26596,15770,42366,8001024
2018-02,Washington,17287,11842,29129,6724540
2018-02,West Virginia,8193,6582,14775,1852994
2018-02,Wisconsin,15379,11979,27358,5686986
2018-02,Wyoming,1851,1916,3767,563626
2018-01,Alabama,5692,6199,11891,4779736
2018-01,Arizona,11659,6992,18651,6392017
2018-01,Arkansas,4935,5061,9996,2915918
2018-01,California,37335,22919,60254,37253956
2018-01,Colorado,17498,12153,29651,5029196
2018-01,Connecticut,5044,1829,6873,3574097
2018-01,Delaware,1422,1224,2646,897934
2018-01,District of Columbia,72,4,76,601723
2018-01,Florida,48377,20690,69067,18801310
2018-01,Georgia,10836,7309,18145,9687653
2018-01,Idaho,3001,3270,6271,1567582
2018-01,Illinois,21821,9850,31671,12830632
2018-01,Indiana,17558,10258,27816,6483802
2018-01,Iowa,119,2004,2123,3046355
2018-01,Kansas,5249,4814,10063,2853118
2018-01,Kentucky,8202,5736,13938,4339367
2018-01,Louisiana,8500,7747,16247,4533372
2018-01,Maine,2585,1926,4511,1328361
2018-01,Maryland,4632,4405,9037,5773552
2018-01,Massachusetts,4554,2468,7022,6547629
2018-01,Michigan,8499,6395,14894,9883640
2018-01,Minnesota,4279,4952,9231,5303925
2018-01,Mississippi,6247,5310,11557,2967297
2018-01,Missouri,17240,12403,29643,5988927
2018-01,Montana,1930,2749,4679,989415
2018-01,Nebraska,106,1717,1823,1826341
2018-01,Nevada,4280,2217,6497,2700551
2018-01,New Hampshire,4277,2352,6629,1316470
2018-01,New Jersey,4309,3491,7800,8791894
2018-01,New Mexico,4995,3801,8796,2059179
2018-01,New York,9091,10156,19247,19378102
2018-01,North Carolina,1271,9931,11202,9535483
2018-01,North Dakota,1331,1914,3245,672591
2018-01,Ohio,21340,12521,33861,11536504
2018-01,Oklahoma,9971,8351,18322,3751351
2018-01,Oregon,12689,8976,21665,3831074
2018-01,Pennsylvania,37308,10242,47550,12702379
2018-01,Rhode Island,1010,618,1628,1052567
2018-01,South Carolina,7896,5151,13047,4625364
2018-01,South Dakota,2217,2799,5016,814180
2018-01,Tennessee,21023,12372,33395,6346105
2018-01,Texas,40443,29960,70403,25145561
2018-01,Utah,3181,3135,6316,2763885
2018-01,Vermont,1116,1000,2116,625741
2018-01,Virginia,19443,12248,31691,8001024
2018-01,Washington,16327,9811,26138,6724540
2018-01,West Virginia,5128,4452,9580,1852994
2018-01,Wisconsin,10484,8337,18821,5686986
2018-01,Wyoming,1460,1534,2994,563626
2017-12,Alabama,12895,15765,28660,4779736
2017-12,Arizona,17566,12840,30406,6392017
2017-12,Arkansas,9189,13104,22293,2915918
2017-12,California,47613,35240,82853,37253956
2017-12,Colorado,26649,21168,47817,5029196
2017-12,Connecticut,6646,2630,9276,3574097
2017-12,Delaware,2295,2473,4768,897934
2017-12,District of Columbia,60,5,65,601723
2017-12,Florida,68075,37127,105202,18801310
2017-12,Georgia,21017,20162,41179,9687653
2017-12,Idaho,5911,7393,13304,1567582
2017-12,Illinois,27956,15126,43082,12830632
2017-12,Indiana,26719,19906,46625,6483802
2017-12,Iowa,231,4678,4909,3046355
2017-12,Kansas,9164,10222,19386,2853118
2017-12,Kentucky,16727,16102,32829,4339367
2017-12,Louisiana,15819,20448,36267,4533372
2017-12,Maine,3873,4336,8209,1328361
2017-12,Maryland,4611,8110,12721,5773552
2017-12,Massachusetts,5954,3448,9402,6547629
2017-12,Michigan,13425,13836,27261,9883640
2017-12,Minnesota,5940,10334,16274,5303925
2017-12,Mississippi,12946,16470,29416,2967297
2017-12,Missouri,28561,27288,55849,5988927
2017-12,Montana,4154,6060,10214,989415
2017-12,Nebraska,197,3773,3970,1826341
2017-12,Nevada,6236,4188,10424,2700551
2017-12,New Hampshire,5977,3690,9667,1316470
2017-12,New Jersey,4039,5089,9128,8791894
2017-12,New Mexico,8205,7494,15699,2059179
2017-12,New York,10187,19662,29849,19378102
2017-12,North Carolina,2452,25060,27512,9535483
2017-12,North Dakota,2019,3285,5304,672591
2017-12,Ohio,34374,27651,62025,11536504
2017-12,Oklahoma,17164,18071,35235,3751351
2017-12,Oregon,18409,15342,33751,3831074
2017-12,Pennsylvania,57826,19809,77635,12702379
2017-12,Rhode Island,1169,790,1959,1052567
2017-12,South Carolina,14549,14083,28632,4625364
2017-12,South Dakota,3537,5348,8885,814180
2017-12,Tennessee,37860,28825,66685,6346105
2017-12,Texas,70767,66779,137546,25145561
2017-12,Utah,6429,8577,15006,2763885
2017-12,Vermont,1722,1824,3546,625741
2017-12,Virginia,31084,25165,56249,8001024
2017-12,Washington,21090,16101,37191,6724540
2017-12,West Virginia,10383,11484,21867,1852994
2017-12,Wisconsin,15745,14414,30159,5686986
2017-12,Wyoming,2763,3104,5867,563626
2017-11,Alabama,9927,11675,21602,4779736
2017-11,Arizona,13763,10322,24085,6392017
2017-11,Arkansas,6981,11574,18555,2915918
2017-11,California,44710,35910,80620,37253956
2017-11,Colorado,23682,17832,41514,5029196
2017-11,Connecticut,5757,2708,8465,3574097
2017-11,Delaware,1802,2244,4046,897934
2017-11,District of Columbia,71,3,74,601723
2017-11,Florida,61694,31631,93325,18801310
2017-11,Georgia,16298,15244,31542,9687653
2017-11,Idaho,4603,6292,10895,1567582
2017-11,Illinois,26122,16102,42224,12830632
2017-11,Indiana,22558,20820,43378,6483802
2017-11,Iowa,280,4847,5127,3046355
2017-11,Kansas,7493,9095,16588,2853118
2017-11,Kentucky,12568,13718,26286,4339367
2017-11,Louisiana,13566,16288,29854,4533372
2017-11,Maine,3270,4056,7326,1328361
2017-11,Maryland,4453,8436,12889,5773552
2017-11,Massachusetts,5691,3782,9473,6547629
2017-11,Michigan,14115,18434,32549,9883640
2017-11,Minnesota,5407,11777,17184,5303925
2017-11,Mississippi,9779,12312,22091,2967297
2017-11,Missouri,23099,26209,49308,5988927
2017-11,Montana,3171,5243,8414,989415
2017-11,Nebraska,216,3612,3828,1826341
2017-11,Nevada,5350,3425,8775,2700551
2017-11,New Hampshire,5266,3743,9009,1316470
2017-11,New Jersey,3771,5459,9230,8791894
2017-11,New Mexico,7206,5820,13026,2059179
2017-11,New York,9160,21742,30902,19378102
2017-11,North Carolina,2123,19943,22066,9535483
2017-11,North Dakota,1924,3382,5306,672591
2017-11,Ohio,30973,28808,59781,11536504
2017-11,Oklahoma,15302,15953,31255,3751351
2017-11,Oregon,15988,13094,29082,3831074
2017-11,Pennsylvania,54967,21597,76564,12702379
2017-11,Rhode Island,1082,742,1824,1052567
2017-11,South Carolina,11512,10108,21620,4625364
2017-11,South Dakota,3049,5354,8403,814180
2017-11,Tennessee,31618,23889,55507,6346105
2017-11,Texas,59840,51536,111376,25145561
2017-11,Utah,5158,6418,11576,2763885
2017-11,Vermont,1231,1839,3070,625741
2017-11,Virginia,26229,22897,49126,8001024
2017-11,Washington,18326,14345,32671,6724540
2017-11,West Virginia,7302,10878,18180,1852994
2017-11,Wisconsin,14237,18174,32411,5686986
2017-11,Wyoming,2165,2545,4710,563626
2017-10,Alabama,6144,6999,13143,4779736
2017-10,Arizona,10614,8055,18669,6392017
2017-10,Arkansas,4873,7420,12293,2915918
2017-10,California,39879,25749,65628,37253956
2017-10,Colorado,17238,15967,33205,5029196
2017-10,Connecticut,5112,2233,7345,3574097
2017-10,Delaware,1602,1587,3189,897934
2017-10,District of Columbia,68,2,70,601723
2017-10,Florida,49568,24580,74148,18801310
2017-10,Georgia,12031,10482,22513,9687653
2017-10,Idaho,3310,5517,8827,1567582
2017-10,Illinois,20093,12503,32596,12830632
2017-10,Indiana,15966,13202,29168,6483802
2017-10,Iowa,126,3209,3335,3046355
2017-10,Kansas,5003,5818,10821,2853118
2017-10,Kentucky,8758,8739,17497,4339367
2017-10,Louisiana,9552,12222,21774,4533372
2017-10,Maine,3076,5806,8882,1328361
2017-10,Maryland,4332,5991,10323,5773552
2017-10,Massachusetts,4950,3030,7980,6547629
2017-10,Michigan,9807,12649,22456,9883640
2017-10,Minnesota,4834,14555,19389,5303925
2017-10,Mississippi,6690,7193,13883,2967297
2017-10,Missouri,17985,19508,37493,5988927
2017-10,Montana,2578,5884,8462,989415
2017-10,Nebraska,118,2469,2587,1826341
2017-10,Nevada,4361,2884,7245,2700551
2017-10,New Hampshire,4425,3568,7993,1316470
2017-10,New Jersey,3798,3869,7667,8791894
2017-10,New Mexico,5651,4928,10579,2059179
2017-10,New York,8501,17695,26196,19378102
2017-10,North Carolina,1501,13877,15378,9535483
2017-10,North Dakota,1367,3732,5099,672591
2017-10,Ohio,22833,18172,41005,11536504
2017-10,Oklahoma,9485,10552,20037,3751351
2017-10,Oregon,12356,11042,23398,3831074
2017-10,Pennsylvania,43923,15604,59527,12702379
2017-10,Rhode Island,937,799,1736,1052567
2017-10,South Carolina,8269,7166,15435,4625364
2017-10,South Dakota,2098,5636,7734,814180
2017-10,Tennessee,21614,16131,37745,6346105
2017-10,Texas,41780,39297,81077,25145561
2017-10,Utah,3075,4257,7332,2763885
2017-10,Vermont,1324,1935,3259,625741
2017-10,Virginia,20450,16169,36619,8001024
2017-10,Washington,14867,13022,27889,6724540
2017-10,West Virginia,5527,7375,12902,1852994
2017-10,Wisconsin,11834,15385,27219,5686986
2017-10,Wyoming,1321,2107,3428,563626
2017-09,Alabama,5734,6320,12054,4779736
2017-09,Arizona,11063,7946,19009,6392017
2017-09,Arkansas,4347,6063,10410,2915918
2017-09,California,37165,24581,61746,37253956
2017-09,Colorado,15751,13448,29199,5029196
2017-09,Connecticut,4834,1993,6827,3574097
2017-09,Delaware,1414,1538,2952,897934
2017-09,District of Columbia,56,4,60,601723
2017-09,Florida,39199,17949,57148,18801310
2017-09,Georgia,10933,7982,18915,9687653
2017-09,Idaho,3058,5241,8299,1567582
2017-09,Illinois,18290,10201,28491,12830632
2017-09,Indiana,16093,11332,27425,6483802
2017-09,Iowa,151,2640,2791,3046355
2017-09,Kansas,4518,5025,9543,2853118
2017-09,Kentucky,8112,7543,15655,4339367
2017-09,Louisiana,10495,11573,22068,4533372
2017-09,Maine,3026,4220,7246,1328361
2017-09,Maryland,3389,4897,8286,5773552
2017-09,Massachusetts,4749,2808,7557,6547629
2017-09,Michigan,8654,10676,19330,9883640
2017-09,Minnesota,4862,12677,17539,5303925
2017-09,Mississippi,6260,6035,12295,2967297
2017-09,Missouri,16993,14395,31388,5988927
2017-09,Montana,2395,4878,7273,989415
2017-09,Nebraska,110,1989,2099,1826341
2017-09,Nevada,3992,2509,6501,2700551
2017-09,New Hampshire,4410,3248,7658,1316470
2017-09,New Jersey,3985,3040,7025,8791894
2017-09,New Mexico,5309,4508,9817,2059179
2017-09,New York,8392,16213,24605,19378102
2017-09,North Carolina,1235,11340,12575,9535483
2017-09,North Dakota,1359,2919,4278,672591
2017-09,Ohio,21085,14998,36083,11536504
2017-09,Oklahoma,8869,9020,17889,3751351
2017-09,Oregon,11557,11773,23330,3831074
2017-09,Pennsylvania,39825,13222,53047,12702379
2017-09,Rhode Island,907,619,1526,1052567
2017-09,South Carolina,7574,6037,13611,4625364
2017-09,South Dakota,2020,4155,6175,814180
2017-09,Tennessee,19219,13746,32965,6346105
2017-09,Texas,39119,39416,78535,25145561
2017-09,Utah,2840,3960,6800,2763885
2017-09,Vermont,1276,1591,2867,625741
2017-09,Virginia,19676,15075,34751,8001024
2017-09,Washington,13292,11548,24840,6724540
2017-09,West Virginia,5204,6161,11365,1852994
2017-09,Wisconsin,10918,13133,24051,5686986
2017-09,Wyoming,1337,2015,3352,563626
2017-08,Alabama,6289,6045,12334,4779736
2017-08,Arizona,10864,7686,18550,6392017
2017-08,Arkansas,4827,5297,10124,2915918
2017-08,California,41110,26220,67330,37253956
2017-08,Colorado,16610,12925,29535,5029196
2017-08,Connecticut,5289,1988,7277,3574097
2017-08,Delaware,1571,1349,2920,897934
2017-08,District of Columbia,54,6,60,601723
2017-08,Florida,46682,21717,68399,18801310
2017-08,Georgia,11719,7797,19516,9687653
2017-08,Idaho,3216,3966,7182,1567582
2017-08,Illinois,19807,11333,31140,12830632
2017-08,Indiana,17271,11844,29115,6483802
2017-08,Iowa,134,2002,2136,3046355
2017-08,Kansas,5005,4743,9748,2853118
2017-08,Kentucky,8039,6555,14594,4339367
2017-08,Louisiana,10124,8788,18912,4533372
2017-08,Maine,3019,2965,5984,1328361
2017-08,Maryland,3657,4807,8464,5773552
2017-08,Massachusetts,4713,2507,7220,6547629
2017-08,Michigan,9849,9962,19811,9883640
2017-08,Minnesota,5446,11294,16740,5303925
2017-08,Mississippi,9059,7738,16797,2967297
2017-08,Missouri,17369,13918,31287,5988927
2017-08,Montana,2597,4034,6631,989415
2017-08,Nebraska,109,1667,1776,1826341
2017-08,Nevada,4052,2251,6303,2700551
2017-08,New Hampshire,4164,2885,7049,1316470
2017-08,New Jersey,4238,3038,7276,8791894
2017-08,New Mexico,5000,3734,8734,2059179
2017-08,New York,9159,13239,22398,19378102
2017-08,North Carolina,1194,11949,13143,9535483
2017-08,North Dakota,1500,2567,4067,672591
2017-08,Ohio,21432,14447,35879,11536504
2017-08,Oklahoma,9732,8978,18710,3751351
2017-08,Oregon,11780,8979,20759,3831074
2017-08,Pennsylvania,40628,13170,53798,12702379
2017-08,Rhode Island,883,596,1479,1052567
2017-08,South Carolina,8268,6421,14689,4625364
2017-08,South Dakota,2082,3233,5315,814180
2017-08,Tennessee,19965,14204,34169,6346105
2017-08,Texas,37277,34884,72161,25145561
2017-08,Utah,2790,3154,5944,2763885
2017-08,Vermont,1232,1254,2486,625741
2017-08,Virginia,20797,14926,35723,8001024
2017-08,Washington,13788,9776,23564,6724540
2017-08,West Virginia,4946,4651,9597,1852994
2017-08,Wisconsin,12749,14317,27066,5686986
2017-08,Wyoming,1411,1762,3173,563626
2017-07,Alabama,6046,4790,10836,4779736
2017-07,Arizona,10194,6363,16557,6392017
2017-07,Arkansas,4343,3804,8147,2915918
2017-07,California,37027,21721,58748,37253956
2017-07,Colorado,16063,11065,27128,5029196
2017-07,Connecticut,5450,1771,7221,3574097
2017-07,Delaware,1417,1000,2417,897934
2017-07,District of Columbia,44,5,49,601723
2017-07,Florida,47430,18941,66371,18801310
2017-07,Georgia,10685,6166,16851,9687653
2017-07,Idaho,2887,3276,6163,1567582
2017-07,Illinois,18417,9895,28312,12830632
2017-07,Indiana,15385,9995,25380,6483802
2017-07,Iowa,94,1649,1743,3046355
2017-07,Kansas,4636,3914,8550,2853118
2017-07,Kentucky,7236,5118,12354,4339367
2017-07,Louisiana,9420,5992,15412,4533372
2017-07,Maine,2695,2259,4954,1328361
2017-07,Maryland,3710,3922,7632,5773552
2017-07,Massachusetts,4034,2150,6184,6547629
2017-07,Michigan,9305,7687,16992,9883640
2017-07,Minnesota,5181,7734,12915,5303925
2017-07,Mississippi,5961,3980,9941,2967297
2017-07,Missouri,16151,11098,27249,5988927
2017-07,Montana,2307,3168,5475,989415
2017-07,Nebraska,97,1204,1301,1826341
2017-07,Nevada,3647,1962,5609,2700551
2017-07,New Hampshire,4228,2427,6655,1316470
2017-07,New Jersey,4351,2519,6870,8791894
2017-07,New Mexico,4834,3254,8088,2059179
2017-07,New York,9212,11301,20513,19378102
2017-07,North Carolina,1059,9316,10375,9535483
2017-07,North Dakota,1286,2030,3316,672591
2017-07,Ohio,20990,14131,35121,11536504
2017-07,Oklahoma,9377,6698,16075,3751351
2017-07,Oregon,11160,7877,19037,3831074
2017-07,Pennsylvania,37329,11694,49023,12702379
2017-07,Rhode Island,836,593,1429,1052567
2017-07,South Carolina,7458,4622,12080,4625364
2017-07,South Dakota,1926,2355,4281,814180
2017-07,Tennessee,20279,11425,31704,6346105
2017-07,Texas,36913,27245,64158,25145561
2017-07,Utah,2562,2546,5108,2763885
2017-07,Vermont,1127,1012,2139,625741
2017-07,Virginia,20688,13381,34069,8001024
2017-07,Washington,12872,8636,21508,6724540
2017-07,West Virginia,4860,4535,9395,1852994
2017-07,Wisconsin,11537,9946,21483,5686986
2017-07,Wyoming,1231,1395,2626,563626
2017-06,Alabama,8275,4782,13057,4779736
2017-06,Arizona,11507,6726,18233,6392017
2017-06,Arkansas,5634,4070,9704,2915918
2017-06,California,42726,23807,66533,37253956
2017-06,Colorado,17781,11298,29079,5029196
2017-06,Connecticut,6203,1765,7968,3574097
2017-06,Delaware,1724,1082,2806,897934
2017-06,District of Columbia,52,5,57,601723
2017-06,Florida,52114,19380,71494,18801310
2017-06,Georgia,13617,6474,20091,9687653
2017-06,Idaho,3645,3698,7343,1567582
2017-06,Illinois,21394,9491,30885,12830632
2017-06,Indiana,18351,9706,28057,6483802
2017-06,Iowa,98,1641,1739,3046355
2017-06,Kansas,5625,3788,9413,2853118
2017-06,Kentucky,8765,5223,13988,4339367
2017-06,Louisiana,11706,6324,18030,4533372
2017-06,Maine,3064,2188,5252,1328361
2017-06,Maryland,3968,3963,7931,5773552
2017-06,Massachusetts,5612,2287,7899,6547629
2017-06,Michigan,11170,7578,18748,9883640
2017-06,Minnesota,6258,7505,13763,5303925
2017-06,Mississippi,7987,4029,12016,2967297
2017-06,Missouri,19459,11470,30929,5988927
2017-06,Montana,3026,3727,6753,989415
2017-06,Nebraska,99,1261,1360,1826341
2017-06,Nevada,4449,2337,6786,2700551
2017-06,New Hampshire,4836,2412,7248,1316470
2017-06,New Jersey,5022,2586,7608,8791894
2017-06,New Mexico,5152,3486,8638,2059179
2017-06,New York,10784,11309,22093,19378102
2017-06,North Carolina,1581,9570,11151,9535483
2017-06,North Dakota,1426,1942,3368,672591
2017-06,Ohio,23703,13536,37239,11536504
2017-06,Oklahoma,11872,7459,19331,3751351
2017-06,Oregon,13632,9218,22850,3831074
2017-06,Pennsylvania,41408,11117,52525,12702379
2017-06,Rhode Island,1053,592,1645,1052567
2017-06,South Carolina,11431,4533,15964,4625364
2017-06,South Dakota,2215,2458,4673,814180
2017-06,Tennessee,23369,11558,34927,6346105
2017-06,Texas,48895,29119,78014,25145561
2017-06,Utah,3307,2989,6296,2763885
2017-06,Vermont,1296,973,2269,625741
2017-06,Virginia,22416,12706,35122,8001024
2017-06,Washington,16674,9805,26479,6724540
2017-06,West Virginia,5409,4165,9574,1852994
2017-06,Wisconsin,13463,9959,23422,5686986
2017-06,Wyoming,1520,1544,3064,563626
2017-05,Alabama,7198,4559,11757,4779736
2017-05,Arizona,12002,6555,18557,6392017
2017-05,Arkansas,5181,3981,9162,2915918
2017-05,California,42442,24495,66937,37253956
2017-05,Colorado,17085,11165,28250,5029196
2017-05,Connecticut,5951,1862,7813,3574097
2017-05,Delaware,1752,1087,2839,897934
2017-05,District of Columbia,66,4,70,601723
2017-05,Florida,49700,18476,68176,18801310
2017-05,Georgia,12163,6211,18374,9687653
2017-05,Idaho,3267,3699,6966,1567582
2017-05,Illinois,22244,9252,31496,12830632
2017-05,Indiana,18110,9483,27593,6483802
2017-05,Iowa,196,1759,1955,3046355
2017-05,Kansas,5022,3818,8840,2853118
2017-05,Kentucky,8690,5378,14068,4339367
2017-05,Louisiana,10362,6302,16664,4533372
2017-05,Maine,3236,2540,5776,1328361
2017-05,Maryland,4539,4244,8783,5773552
2017-05,Massachusetts,5100,2526,7626,6547629
2017-05,Michigan,10483,7055,17538,9883640
2017-05,Minnesota,7916,7597,15513,5303925
2017-05,Mississippi,7002,3938,10940,2967297
2017-05,Missouri,18290,11468,29758,5988927
2017-05,Montana,2660,3762,6422,989415
2017-05,Nebraska,109,1256,1365,1826341
2017-05,Nevada,4630,2288,6918,2700551
2017-05,New Hampshire,4614,2472,7086,1316470
2017-05,New Jersey,5569,2931,8500,8791894
2017-05,New Mexico,5204,3381,8585,2059179
2017-05,New York,11633,12857,24490,19378102
2017-05,North Carolina,1363,9129,10492,9535483
2017-05,North Dakota,1413,1866,3279,672591
2017-05,Ohio,25230,12924,38154,11536504
2017-05,Oklahoma,10599,7270,17869,3751351
2017-05,Oregon,13261,9115,22376,3831074
2017-05,Pennsylvania,42646,11123,53769,12702379
2017-05,Rhode Island,1048,541,1589,1052567
2017-05,South Carolina,9258,4234,13492,4625364
2017-05,South Dakota,2369,2578,4947,814180
2017-05,Tennessee,22198,10745,32943,6346105
2017-05,Texas,42366,27991,70357,25145561
2017-05,Utah,3204,3144,6348,2763885
2017-05,Vermont,1306,1132,2438,625741
2017-05,Virginia,21697,12181,33878,8001024
2017-05,Washington,15915,9682,25597,6724540
2017-05,West Virginia,5818,4329,10147,1852994
2017-05,Wisconsin,14070,9467,23537,5686986
2017-05,Wyoming,1589,1578,3167,563626
2017-04,Alabama,7131,4724,11855,4779736
2017-04,Arizona,13302,7485,20787,6392017
2017-04,Arkansas,5670,4226,9896,2915918
2017-04,California,45182,24898,70080,37253956
2017-04,Colorado,19453,12407,31860,5029196
2017-04,Connecticut,6557,2063,8620,3574097
2017-04,Delaware,2017,1249,3266,897934
2017-04,District of Columbia,68,1,69,601723
2017-04,Florida,52889,19489,72378,18801310
2017-04,Georgia,13202,6567,19769,9687653
2017-04,Idaho,3874,4039,7913,1567582
2017-04,Illinois,25414,10416,35830,12830632
2017-04,Indiana,21454,11390,32844,6483802
2017-04,Iowa,252,2348,2600,3046355
2017-04,Kansas,5901,4435,10336,2853118
2017-04,Kentucky,9858,6519,16377,4339367
2017-04,Louisiana,10551,6161,16712,4533372
2017-04,Maine,3816,3073,6889,1328361
2017-04,Maryland,4435,5128,9563,5773552
2017-04,Massachusetts,6540,2717,9257,6547629
2017-04,Michigan,12478,9139,21617,9883640
2017-04,Minnesota,13074,12144,25218,5303925
2017-04,Mississippi,7952,4359,12311,2967297
2017-04,Missouri,20328,14124,34452,5988927
2017-04,Montana,3014,4246,7260,989415
2017-04,Nebraska,126,1648,1774,1826341
2017-04,Nevada,4890,2747,7637,2700551
2017-04,New Hampshire,5658,3121,8779,1316470
2017-04,New Jersey,5722,3201,8923,8791894
2017-04,New Mexico,5665,4023,9688,2059179
2017-04,New York,11913,14591,26504,19378102
2017-04,North Carolina,1471,9870,11341,9535483
2017-04,North Dakota,2209,2492,4701,672591
2017-04,Ohio,31417,16030,47447,11536504
2017-04,Oklahoma,13317,9111,22428,3751351
2017-04,Oregon,15122,10896,26018,3831074
2017-04,Pennsylvania,48255,11877,60132,12702379
2017-04,Rhode Island,1146,673,1819,1052567
2017-04,South Carolina,9548,4420,13968,4625364
2017-04,South Dakota,2896,3008,5904,814180
2017-04,Tennessee,23031,11521,34552,6346105
2017-04,Texas,44994,28015,73009,25145561
2017-04,Utah,3917,3302,7219,2763885
2017-04,Vermont,1855,1720,3575,625741
2017-04,Virginia,29480,16844,46324,8001024
2017-04,Washington,17120,10659,27779,6724540
2017-04,West Virginia,6723,5263,11986,1852994
2017-04,Wisconsin,16700,13302,30002,5686986
2017-04,Wyoming,1633,1711,3344,563626
2017-03,Alabama,10603,6951,17554,4779736
2017-03,Arizona,14897,9036,23933,6392017
2017-03,Arkansas,7907,6010,13917,2915918
2017-03,California,48732,27839,76571,37253956
2017-03,Colorado,21249,14378,35627,5029196
2017-03,Connecticut,7476,2551,10027,3574097
2017-03,Delaware,2557,1677,4234,897934
2017-03,District of Columbia,83,3,86,601723
2017-03,Florida,60787,23982,84769,18801310
2017-03,Georgia,19256,9518,28774,9687653
2017-03,Idaho,4500,4944,9444,1567582
2017-03,Illinois,30518,14411,44929,12830632
2017-03,Indiana,28593,14363,42956,6483802
2017-03,Iowa,316,3137,3453,3046355
2017-03,Kansas,7712,5522,13234,2853118
2017-03,Kentucky,13769,8992,22761,4339367
2017-03,Louisiana,13973,8092,22065,4533372
2017-03,Maine,4558,3286,7844,1328361
2017-03,Maryland,5398,5737,11135,5773552
2017-03,Massachusetts,7274,3421,10695,6547629
2017-03,Michigan,16031,11103,27134,9883640
2017-03,Minnesota,14029,12988,27017,5303925
2017-03,Mississippi,11586,6508,18094,2967297
2017-03,Missouri,27625,17931,45556,5988927
2017-03,Montana,3615,4584,8199,989415
2017-03,Nebraska,176,1984,2160,1826341
2017-03,Nevada,6038,3219,9257,2700551
2017-03,New Hampshire,7278,3462,10740,1316470
2017-03,New Jersey,6871,3864,10735,8791894
2017-03,New Mexico,6752,4571,11323,2059179
2017-03,New York,12788,15591,28379,19378102
2017-03,North Carolina,1669,13837,15506,9535483
2017-03,North Dakota,2013,2371,4384,672591
2017-03,Ohio,37474,19925,57399,11536504
2017-03,Oklahoma,14157,10065,24222,3751351
2017-03,Oregon,17177,13521,30698,3831074
2017-03,Pennsylvania,61207,15836,77043,12702379
2017-03,Rhode Island,1424,791,2215,1052567
2017-03,South Carolina,13284,6749,20033,4625364
2017-03,South Dakota,3361,3686,7047,814180
2017-03,Tennessee,29369,15922,45291,6346105
2017-03,Texas,55983,34308,90291,25145561
2017-03,Utah,4401,4010,8411,2763885
2017-03,Vermont,2007,1793,3800,625741
2017-03,Virginia,29873,17754,47627,8001024
2017-03,Washington,20308,12740,33048,6724540
2017-03,West Virginia,8887,6616,15503,1852994
2017-03,Wisconsin,19864,16763,36627,5686986
2017-03,Wyoming,2017,2038,4055,563626
2017-02,Alabama,10739,7028,17767,4779736
2017-02,Arizona,15642,8881,24523,6392017
2017-02,Arkansas,7974,5938,13912,2915918
2017-02,California,44363,24987,69350,37253956
2017-02,Colorado,20958,13477,34435,5029196
2017-02,Connecticut,6445,2187,8632,3574097
2017-02,Delaware,2342,1663,4005,897934
2017-02,District of Columbia,65,1,66,601723
2017-02,Florida,59201,23479,82680,18801310
2017-02,Georgia,19007,9334,28341,9687653
2017-02,Idaho,4051,3904,7955,1567582
2017-02,Illinois,27418,12635,40053,12830632
2017-02,Indiana,27343,13221,40564,6483802
2017-02,Iowa,318,2403,2721,3046355
2017-02,Kansas,8082,5501,13583,2853118
2017-02,Kentucky,14975,8636,23611,4339367
2017-02,Louisiana,12698,7601,20299,4533372
2017-02,Maine,3758,2544,6302,1328361
2017-02,Maryland,4925,5534,10459,5773552
2017-02,Massachusetts,6280,2901,9181,6547629
2017-02,Michigan,15564,9804,25368,9883640
2017-02,Minnesota,12047,9641,21688,5303925
2017-02,Mississippi,11285,6045,17330,2967297
2017-02,Missouri,26726,16012,42738,5988927
2017-02,Montana,2912,3429,6341,989415
2017-02,Nebraska,171,1937,2108,1826341
2017-02,Nevada,5644,2732,8376,2700551
2017-02,New Hampshire,6092,3098,9190,1316470
2017-02,New Jersey,5904,3481,9385,8791894
2017-02,New Mexico,7032,4632,11664,2059179
2017-02,New York,11465,14080,25545,19378102
2017-02,North Carolina,1410,13488,14898,9535483
2017-02,North Dakota,1807,2213,4020,672591
2017-02,Ohio,36244,18068,54312,11536504
2017-02,Oklahoma,14051,9769,23820,3751351
2017-02,Oregon,16425,11726,28151,3831074
2017-02,Pennsylvania,54107,12734,66841,12702379
2017-02,Rhode Island,1278,731,2009,1052567
2017-02,South Carolina,12510,6324,18834,4625364
2017-02,South Dakota,3569,3533,7102,814180
2017-02,Tennessee,31982,16425,48407,6346105
2017-02,Texas,56786,33238,90024,25145561
2017-02,Utah,4371,4252,8623,2763885
2017-02,Vermont,1885,1538,3423,625741
2017-02,Virginia,28434,16587,45021,8001024
2017-02,Washington,18785,11860,30645,6724540
2017-02,West Virginia,8917,6203,15120,1852994
2017-02,Wisconsin,18147,12247,30394,5686986
2017-02,Wyoming,1839,1646,3485,563626
2017-01,Alabama,6770,6572,13342,4779736
2017-01,Arizona,12108,7353,19461,6392017
2017-01,Arkansas,5174,5278,10452,2915918
2017-01,California,41516,22686,64202,37253956
2017-01,Colorado,17189,11864,29053,5029196
2017-01,Connecticut,6133,2115,8248,3574097
2017-01,Delaware,1815,1466,3281,897934
2017-01,District of Columbia,69,6,75,601723
2017-01,Florida,51599,21867,73466,18801310
2017-01,Georgia,12519,7945,20464,9687653
2017-01,Idaho,2617,3049,5666,1567582
2017-01,Illinois,24594,11185,35779,12830632
2017-01,Indiana,21284,11456,32740,6483802
2017-01,Iowa,180,2015,2195,3046355
2017-01,Kansas,5798,4969,10767,2853118
2017-01,Kentucky,9743,6700,16443,4339367
2017-01,Louisiana,10709,8701,19410,4533372
2017-01,Maine,3094,2447,5541,1328361
2017-01,Maryland,4456,5254,9710,5773552
2017-01,Massachusetts,6069,2871,8940,6547629
2017-01,Michigan,10181,7490,17671,9883640
2017-01,Minnesota,9389,7266,16655,5303925
2017-01,Mississippi,6805,5592,12397,2967297
2017-01,Missouri,20123,13512,33635,5988927
2017-01,Montana,2015,2748,4763,989415
2017-01,Nebraska,141,1673,1814,1826341
2017-01,Nevada,4235,2361,6596,2700551
2017-01,New Hampshire,5332,2836,8168,1316470
2017-01,New Jersey,5719,3355,9074,8791894
2017-01,New Mexico,4781,3641,8422,2059179
2017-01,New York,11059,13412,24471,19378102
2017-01,North Carolina,1073,11218,12291,9535483
2017-01,North Dakota,1370,1892,3262,672591
2017-01,Ohio,27124,15070,42194,11536504
2017-01,Oklahoma,10811,8883,19694,3751351
2017-01,Oregon,12071,8985,21056,3831074
2017-01,Pennsylvania,44199,10689,54888,12702379
2017-01,Rhode Island,1196,687,1883,1052567
2017-01,South Carolina,9374,5678,15052,4625364
2017-01,South Dakota,2371,2803,5174,814180
2017-01,Tennessee,23009,13583,36592,6346105
2017-01,Texas,42697,31314,74011,25145561
2017-01,Utah,3031,2961,5992,2763885
2017-01,Vermont,1338,1214,2552,625741
2017-01,Virginia,21375,14319,35694,8001024
2017-01,Washington,15595,9913,25508,6724540
2017-01,West Virginia,5837,4995,10832,1852994
2017-01,Wisconsin,12346,8888,21234,5686986
2017-01,Wyoming,1329,1433,2762,563626
2016-12,Alabama,13733,17519,31252,4779736
2016-12,Arizona,18024,13785,31809,6392017
2016-12,Arkansas,9192,13433,22625,2915918
2016-12,California,63649,93224,156873,37253956
2016-12,Colorado,25905,21134,47039,5029196
2016-12,Connecticut,8003,3153,11156,3574097
2016-12,Delaware,2689,2981,5670,897934
2016-12,District of Columbia,60,5,65,601723
2016-12,Florida,69842,39880,109722,18801310
2016-12,Georgia,23875,22613,46488,9687653
2016-12,Idaho,5471,7074,12545,1567582
2016-12,Illinois,29658,17164,46822,12830632
2016-12,Indiana,30248,21688,51936,6483802
2016-12,Iowa,391,4822,5213,3046355
2016-12,Kansas,8494,10473,18967,2853118
2016-12,Kentucky,17311,16766,34077,4339367
2016-12,Louisiana,18412,22848,41260,4533372
2016-12,Maine,4641,4713,9354,1328361
2016-12,Maryland,4925,8870,13795,5773552
2016-12,Massachusetts,7050,3884,10934,6547629
2016-12,Michigan,14879,14328,29207,9883640
2016-12,Minnesota,12431,12851,25282,5303925
2016-12,Mississippi,13168,17231,30399,2967297
2016-12,Missouri,29770,27013,56783,5988927
2016-12,Montana,3822,5832,9654,989415
2016-12,Nebraska,268,3697,3965,1826341
2016-12,Nevada,6783,4696,11479,2700551
2016-12,New Hampshire,6625,4225,10850,1316470
2016-12,New Jersey,5394,4979,10373,8791894
2016-12,New Mexico,7484,7149,14633,2059179
2016-12,New York,12074,22585,34659,19378102
2016-12,North Carolina,2163,28023,30186,9535483
2016-12,North Dakota,1799,2927,4726,672591
2016-12,Ohio,40996,29641,70637,11536504
2016-12,Oklahoma,17990,19418,37408,3751351
2016-12,Oregon,18931,16010,34941,3831074
2016-12,Pennsylvania,64220,18688,82908,12702379
2016-12,Rhode Island,1283,953,2236,1052567
2016-12,South Carolina,15600,14782,30382,4625364
2016-12,South Dakota,3525,5131,8656,814180
2016-12,Tennessee,36917,30997,67914,6346105
2016-12,Texas,69163,69272,138435,25145561
2016-12,Utah,6428,9257,15685,2763885
2016-12,Vermont,1802,1998,3800,625741
2016-12,Virginia,32572,27619,60191,8001024
2016-12,Washington,21835,16484,38319,6724540
2016-12,West Virginia,10869,11628,22497,1852994
2016-12,Wisconsin,16521,15036,31557,5686986
2016-12,Wyoming,2540,2984,5524,563626
2016-11,Alabama,10214,13470,23684,4779736
2016-11,Arizona,14850,11994,26844,6392017
2016-11,Arkansas,7226,11866,19092,2915918
2016-11,California,56932,82554,139486,37253956
2016-11,Colorado,24052,19794,43846,5029196
2016-11,Connecticut,7063,3258,10321,3574097
2016-11,Delaware,2490,2751,5241,897934
2016-11,District of Columbia,49,5,54,601723
2016-11,Florida,62351,35718,98069,18801310
2016-11,Georgia,18011,16759,34770,9687653
2016-11,Idaho,4711,6175,10886,1567582
2016-11,Illinois,28463,19005,47468,12830632
2016-11,Indiana,25246,23336,48582,6483802
2016-11,Iowa,399,5112,5511,3046355
2016-11,Kansas,8136,9854,17990,2853118
2016-11,Kentucky,12847,14844,27691,4339367
2016-11,Louisiana,14674,18349,33023,4533372
2016-11,Maine,4135,5097,9232,1328361
2016-11,Maryland,5356,9509,14865,5773552
2016-11,Massachusetts,7117,4783,11900,6547629
2016-11,Michigan,15803,18241,34044,9883640
2016-11,Minnesota,12338,15597,27935,5303925
2016-11,Mississippi,9382,13481,22863,2967297
2016-11,Missouri,23719,26338,50057,5988927
2016-11,Montana,3093,5546,8639,989415
2016-11,Nebraska,216,3688,3904,1826341
2016-11,Nevada,6338,4291,10629,2700551
2016-11,New Hampshire,6283,4822,11105,1316470
2016-11,New Jersey,5398,5720,11118,8791894
2016-11,New Mexico,6153,6034,12187,2059179
2016-11,New York,11157,25229,36386,19378102
2016-11,North Carolina,1709,23215,24924,9535483
2016-11,North Dakota,1827,3546,5373,672591
2016-11,Ohio,37304,32312,69616,11536504
2016-11,Oklahoma,16348,17019,33367,3751351
2016-11,Oregon,17013,15711,32724,3831074
2016-11,Pennsylvania,66188,20487,86675,12702379
2016-11,Rhode Island,1271,1065,2336,1052567
2016-11,South Carolina,12839,11547,24386,4625364
2016-11,South Dakota,3456,5677,9133,814180
2016-11,Tennessee,29502,25976,55478,6346105
2016-11,Texas,58778,56057,114835,25145561
2016-11,Utah,5232,7021,12253,2763885
2016-11,Vermont,1342,1975,3317,625741
2016-11,Virginia,29544,26823,56367,8001024
2016-11,Washington,19534,16266,35800,6724540
2016-11,West Virginia,7824,11134,18958,1852994
2016-11,Wisconsin,17580,19631,37211,5686986
2016-11,Wyoming,2097,2691,4788,563626
2016-10,Alabama,7757,8865,16622,4779736
2016-10,Arizona,12405,9382,21787,6392017
2016-10,Arkansas,5607,8235,13842,2915918
2016-10,California,45785,54333,100118,37253956
2016-10,Colorado,20343,16962,37305,5029196
2016-10,Connecticut,6374,2698,9072,3574097
2016-10,Delaware,2070,2082,4152,897934
2016-10,District of Columbia,59,2,61,601723
2016-10,Florida,50003,27010,77013,18801310
2016-10,Georgia,13799,12262,26061,9687653
2016-10,Idaho,3913,5787,9700,1567582
2016-10,Illinois,33986,14739,48725,12830632
2016-10,Indiana,21058,16857,37915,6483802
2016-10,Iowa,221,3557,3778,3046355
2016-10,Kansas,6527,6775,13302,2853118
2016-10,Kentucky,10111,10030,20141,4339367
2016-10,Louisiana,11865,13673,25538,4533372
2016-10,Maine,4320,6926,11246,1328361
2016-10,Maryland,4280,6786,11066,5773552
2016-10,Massachusetts,6415,3680,10095,6547629
2016-10,Michigan,12680,13539,26219,9883640
2016-10,Minnesota,11394,18553,29947,5303925
2016-10,Mississippi,7564,8323,15887,2967297
2016-10,Missouri,21994,20919,42913,5988927
2016-10,Montana,3035,6689,9724,989415
2016-10,Nebraska,144,2817,2961,1826341
2016-10,Nevada,5614,3471,9085,2700551
2016-10,New Hampshire,5968,4672,10640,1316470
2016-10,New Jersey,5391,4567,9958,8791894
2016-10,New Mexico,5449,4826,10275,2059179
2016-10,New York,10820,21094,31914,19378102
2016-10,North Carolina,1353,15980,17333,9535483
2016-10,North Dakota,1674,4451,6125,672591
2016-10,Ohio,30593,21991,52584,11536504
2016-10,Oklahoma,11560,11325,22885,3751351
2016-10,Oregon,14749,13412,28161,3831074
2016-10,Pennsylvania,56836,16223,73059,12702379
2016-10,Rhode Island,1162,950,2112,1052567
2016-10,South Carolina,9270,7797,17067,4625364
2016-10,South Dakota,3127,6859,9986,814180
2016-10,Tennessee,23542,18514,42056,6346105
2016-10,Texas,46518,44519,91037,25145561
2016-10,Utah,3588,4603,8191,2763885
2016-10,Vermont,1485,2099,3584,625741
2016-10,Virginia,24337,20433,44770,8001024
2016-10,Washington,18601,15455,34056,6724540
2016-10,West Virginia,6721,7737,14458,1852994
2016-10,Wisconsin,15514,17376,32890,5686986
2016-10,Wyoming,1709,2307,4016,563626
2016-09,Alabama,7125,8449,15574,4779736
2016-09,Arizona,11769,8951,20720,6392017
2016-09,Arkansas,4802,6284,11086,2915918
2016-09,California,39213,43015,82228,37253956
2016-09,Colorado,17390,14521,31911,5029196
2016-09,Connecticut,5424,2472,7896,3574097
2016-09,Delaware,1759,1894,3653,897934
2016-09,District of Columbia,46,4,50,601723
2016-09,Florida,45848,22439,68287,18801310
2016-09,Georgia,12258,9766,22024,9687653
2016-09,Idaho,3124,5230,8354,1567582
2016-09,Illinois,20298,11876,32174,12830632
2016-09,Indiana,17402,13402,30804,6483802
2016-09,Iowa,154,2694,2848,3046355
2016-09,Kansas,4903,5614,10517,2853118
2016-09,Kentucky,8917,8172,17089,4339367
2016-09,Louisiana,12875,13747,26622,4533372
2016-09,Maine,3841,5203,9044,1328361
2016-09,Maryland,3626,5428,9054,5773552
2016-09,Massachusetts,5584,3210,8794,6547629
2016-09,Michigan,10056,11311,21367,9883640
2016-09,Minnesota,9548,16213,25761,5303925
2016-09,Mississippi,6904,6592,13496,2967297
2016-09,Missouri,17808,15528,33336,5988927
2016-09,Montana,2702,5404,8106,989415
2016-09,Nebraska,104,2144,2248,1826341
2016-09,Nevada,4281,2764,7045,2700551
2016-09,New Hampshire,5100,3766,8866,1316470
2016-09,New Jersey,5249,3864,9113,8791894
2016-09,New Mexico,4793,4277,9070,2059179
2016-09,New York,9700,17804,27504,19378102
2016-09,North Carolina,1068,14018,15086,9535483
2016-09,North Dakota,1273,3381,4654,672591
2016-09,Ohio,24297,18038,42335,11536504
2016-09,Oklahoma,9638,10003,19641,3751351
2016-09,Oregon,13325,13046,26371,3831074
2016-09,Pennsylvania,46101,12697,58798,12702379
2016-09,Rhode Island,1031,767,1798,1052567
2016-09,South Carolina,8725,7088,15813,4625364
2016-09,South Dakota,2530,4663,7193,814180
2016-09,Tennessee,20721,15120,35841,6346105
2016-09,Texas,37858,42308,80166,25145561
2016-09,Utah,2918,4440,7358,2763885
2016-09,Vermont,1233,1701,2934,625741
2016-09,Virginia,20325,16687,37012,8001024
2016-09,Washington,15261,13621,28882,6724540
2016-09,West Virginia,6122,6495,12617,1852994
2016-09,Wisconsin,13271,14796,28067,5686986
2016-09,Wyoming,1521,2207,3728,563626
2016-08,Alabama,8243,7808,16051,4779736
2016-08,Arizona,12069,8601,20670,6392017
2016-08,Arkansas,5666,6108,11774,2915918
2016-08,California,43344,43552,86896,37253956
2016-08,Colorado,18116,14054,32170,5029196
2016-08,Connecticut,9929,3941,13870,3574097
2016-08,Delaware,1662,1562,3224,897934
2016-08,District of Columbia,56,3,59,601723
2016-08,Florida,49867,23359,73226,18801310
2016-08,Georgia,12627,9187,21814,9687653
2016-08,Idaho,3194,4214,7408,1567582
2016-08,Illinois,60745,30602,91347,12830632
2016-08,Indiana,18906,13606,32512,6483802
2016-08,Iowa,182,2345,2527,3046355
2016-08,Kansas,4987,5437,10424,2853118
2016-08,Kentucky,8842,7187,16029,4339367
2016-08,Louisiana,13082,10527,23609,4533372
2016-08,Maine,3294,3546,6840,1328361
2016-08,Maryland,4249,5109,9358,5773552
2016-08,Massachusetts,5601,2915,8516,6547629
2016-08,Michigan,10650,9117,19767,9883640
2016-08,Minnesota,9391,11884,21275,5303925
2016-08,Mississippi,11193,9085,20278,2967297
2016-08,Missouri,18394,15365,33759,5988927
2016-08,Montana,2882,4487,7369,989415
2016-08,Nebraska,126,1805,1931,1826341
2016-08,Nevada,4676,2629,7305,2700551
2016-08,New Hampshire,4732,3421,8153,1316470
2016-08,New Jersey,5541,3962,9503,8791894
2016-08,New Mexico,5170,4224,9394,2059179
2016-08,New York,10716,14278,24994,19378102
2016-08,North Carolina,1208,12513,13721,9535483
2016-08,North Dakota,1284,2601,3885,672591
2016-08,Ohio,26261,17526,43787,11536504
2016-08,Oklahoma,10881,9762,20643,3751351
2016-08,Oregon,12661,10173,22834,3831074
2016-08,Pennsylvania,46155,11700,57855,12702379
2016-08,Rhode Island,1039,770,1809,1052567
2016-08,South Carolina,8828,6906,15734,4625364
2016-08,South Dakota,2387,3559,5946,814180
2016-08,Tennessee,22737,16198,38935,6346105
2016-08,Texas,42302,40269,82571,25145561
2016-08,Utah,2917,3503,6420,2763885
2016-08,Vermont,1269,1296,2565,625741
2016-08,Virginia,21108,15802,36910,8001024
2016-08,Washington,15083,11376,26459,6724540
2016-08,West Virginia,6916,5283,12199,1852994
2016-08,Wisconsin,14764,12079,26843,5686986
2016-08,Wyoming,1721,2079,3800,563626
2016-07,Alabama,10132,7392,17524,4779736
2016-07,Arizona,13693,8643,22336,6392017
2016-07,Arkansas,6323,5053,11376,2915918
2016-07,California,46361,47594,93955,37253956
2016-07,Colorado,18765,15176,33941,5029196
2016-07,Connecticut,11328,4015,15343,3574097
2016-07,Delaware,1859,1569,3428,897934
2016-07,District of Columbia,57,1,58,601723
2016-07,Florida,57902,28000,85902,18801310
2016-07,Georgia,15342,8597,23939,9687653
2016-07,Idaho,3592,3576,7168,1567582
2016-07,Illinois,21421,11881,33302,12830632
2016-07,Indiana,19508,12191,31699,6483802
2016-07,Iowa,186,2227,2413,3046355
2016-07,Kansas,6075,4942,11017,2853118
2016-07,Kentucky,9378,6615,15993,4339367
2016-07,Louisiana,21637,12252,33889,4533372
2016-07,Maine,3426,3026,6452,1328361
2016-07,Maryland,3973,5505,9478,5773552
2016-07,Massachusetts,6257,5108,11365,6547629
2016-07,Michigan,11308,8095,19403,9883640
2016-07,Minnesota,9743,9207,18950,5303925
2016-07,Mississippi,10425,6125,16550,2967297
2016-07,Missouri,20791,13575,34366,5988927
2016-07,Montana,2894,3882,6776,989415
2016-07,Nebraska,93,1529,1622,1826341
2016-07,Nevada,5194,3006,8200,2700551
2016-07,New Hampshire,5200,3716,8916,1316470
2016-07,New Jersey,5708,4155,9863,8791894
2016-07,New Mexico,5380,3966,9346,2059179
2016-07,New York,10900,13073,23973,19378102
2016-07,North Carolina,1157,12487,13644,9535483
2016-07,North Dakota,1333,2457,3790,672591
2016-07,Ohio,27876,17720,45596,11536504
2016-07,Oklahoma,11750,8792,20542,3751351
2016-07,Oregon,14284,10507,24791,3831074
2016-07,Pennsylvania,46843,11793,58636,12702379
2016-07,Rhode Island,1133,951,2084,1052567
2016-07,South Carolina,9967,5880,15847,4625364
2016-07,South Dakota,2490,3004,5494,814180
2016-07,Tennessee,26276,16118,42394,6346105
2016-07,Texas,50499,34266,84765,25145561
2016-07,Utah,3381,3328,6709,2763885
2016-07,Vermont,1293,1201,2494,625741
2016-07,Virginia,24671,16731,41402,8001024
2016-07,Washington,15652,11536,27188,6724540
2016-07,West Virginia,6417,5134,11551,1852994
2016-07,Wisconsin,13182,9870,23052,5686986
2016-07,Wyoming,1619,1769,3388,563626
2016-06,Alabama,9146,7273,16419,4779736
2016-06,Arizona,12942,8614,21556,6392017
2016-06,Arkansas,5454,4574,10028,2915918
2016-06,California,43042,37512,80554,37253956
2016-06,Colorado,17790,15115,32905,5029196
2016-06,Connecticut,12011,3974,15985,3574097
2016-06,Delaware,1842,1621,3463,897934
2016-06,District of Columbia,46,3,49,601723
2016-06,Florida,55934,29501,85435,18801310
2016-06,Georgia,13307,7859,21166,9687653
2016-06,Idaho,3445,4143,7588,1567582
2016-06,Illinois,22277,12787,35064,12830632
2016-06,Indiana,18307,11949,30256,6483802
2016-06,Iowa,129,2004,2133,3046355
2016-06,Kansas,5275,4447,9722,2853118
2016-06,Kentucky,8703,6584,15287,4339367
2016-06,Louisiana,12082,8428,20510,4533372
2016-06,Maine,3433,2943,6376,1328361
2016-06,Maryland,4288,4864,9152,5773552
2016-06,Massachusetts,5965,3404,9369,6547629
2016-06,Michigan,10335,8282,18617,9883640
2016-06,Minnesota,8880,9723,18603,5303925
2016-06,Mississippi,7804,4692,12496,2967297
2016-06,Missouri,18770,13295,32065,5988927
2016-06,Montana,2968,4379,7347,989415
2016-06,Nebraska,107,1609,1716,1826341
2016-06,Nevada,4949,3114,8063,2700551
2016-06,New Hampshire,5166,3453,8619,1316470
2016-06,New Jersey,6266,4294,10560,8791894
2016-06,New Mexico,5336,4231,9567,2059179
2016-06,New York,10062,12213,22275,19378102
2016-06,North Carolina,1181,11749,12930,9535483
2016-06,North Dakota,1312,2377,3689,672591
2016-06,Ohio,24397,17086,41483,11536504
2016-06,Oklahoma,11933,8811,20744,3751351
2016-06,Oregon,14054,11400,25454,3831074
2016-06,Pennsylvania,44677,11841,56518,12702379
2016-06,Rhode Island,1146,862,2008,1052567
2016-06,South Carolina,9619,5599,15218,4625364
2016-06,South Dakota,2460,3139,5599,814180
2016-06,Tennessee,22476,15194,37670,6346105
2016-06,Texas,46816,33501,80317,25145561
2016-06,Utah,3433,3731,7164,2763885
2016-06,Vermont,1240,1225,2465,625741
2016-06,Virginia,20132,15480,35612,8001024
2016-06,Washington,17040,13267,30307,6724540
2016-06,West Virginia,6602,4821,11423,1852994
2016-06,Wisconsin,12464,11144,23608,5686986
2016-06,Wyoming,1638,2110,3748,563626
2016-05,Alabama,7903,5256,13159,4779736
2016-05,Arizona,10994,6539,17533,6392017
2016-05,Arkansas,4551,3596,8147,2915918
2016-05,California,38301,28723,67024,37253956
2016-05,Colorado,16293,11252,27545,5029196
2016-05,Connecticut,9953,3362,13315,3574097
2016-05,Delaware,1722,1121,2843,897934
2016-05,District of Columbia,47,6,53,601723
2016-05,Florida,42845,17025,59870,18801310
2016-05,Georgia,10866,5510,16376,9687653
2016-05,Idaho,3132,3323,6455,1567582
2016-05,Illinois,19264,8686,27950,12830632
2016-05,Indiana,16842,9264,26106,6483802
2016-05,Iowa,121,1569,1690,3046355
2016-05,Kansas,4648,3553,8201,2853118
2016-05,Kentucky,8049,5244,13293,4339367
2016-05,Louisiana,9561,5788,15349,4533372
2016-05,Maine,3009,2464,5473,1328361
2016-05,Maryland,4099,4148,8247,5773552
2016-05,Massachusetts,5278,2325,7603,6547629
2016-05,Michigan,9834,6490,16324,9883640
2016-05,Minnesota,8772,7638,16410,5303925
2016-05,Mississippi,7005,3541,10546,2967297
2016-05,Missouri,16909,10162,27071,5988927
2016-05,Montana,2724,3881,6605,989415
2016-05,Nebraska,78,1277,1355,1826341
2016-05,Nevada,4365,2329,6694,2700551
2016-05,New Hampshire,4262,2645,6907,1316470
2016-05,New Jersey,6542,3027,9569,8791894
2016-05,New Mexico,4485,3269,7754,2059179
2016-05,New York,10118,10815,20933,19378102
2016-05,North Carolina,1119,8506,9625,9535483
2016-05,North Dakota,1186,1798,2984,672591
2016-05,Ohio,26069,13219,39288,11536504
2016-05,Oklahoma,10385,6490,16875,3751351
2016-05,Oregon,12038,9194,21232,3831074
2016-05,Pennsylvania,39963,8770,48733,12702379
2016-05,Rhode Island,936,536,1472,1052567
2016-05,South Carolina,7570,3922,11492,4625364
2016-05,South Dakota,2161,2666,4827,814180
2016-05,Tennessee,19232,10394,29626,6346105
2016-05,Texas,39446,25424,64870,25145561
2016-05,Utah,3097,3067,6164,2763885
2016-05,Vermont,1096,1026,2122,625741
2016-05,Virginia,18183,10896,29079,8001024
2016-05,Washington,14601,9033,23634,6724540
2016-05,West Virginia,6099,4179,10278,1852994
2016-05,Wisconsin,11438,8481,19919,5686986
2016-05,Wyoming,1497,1671,3168,563626
2016-04,Alabama,9742,6977,16719,4779736
2016-04,Arizona,13086,7278,20364,6392017
2016-04,Arkansas,5334,4513,9847,2915918
2016-04,California,41862,30133,71995,37253956
2016-04,Colorado,17897,12560,30457,5029196
2016-04,Connecticut,11882,3936,15818,3574097
2016-04,Delaware,1878,1313,3191,897934
2016-04,District of Columbia,55,3,58,601723
2016-04,Florida,48697,19716,68413,18801310
2016-04,Georgia,13673,6764,20437,9687653
2016-04,Idaho,3376,3720,7096,1567582
2016-04,Illinois,24894,11132,36026,12830632
2016-04,Indiana,20756,12137,32893,6483802
2016-04,Iowa,184,2453,2637,3046355
2016-04,Kansas,5785,4540,10325,2853118
2016-04,Kentucky,9657,7070,16727,4339367
2016-04,Louisiana,11703,6552,18255,4533372
2016-04,Maine,3970,3254,7224,1328361
2016-04,Maryland,4294,4966,9260,5773552
2016-04,Massachusetts,6227,3009,9236,6547629
2016-04,Michigan,13598,8647,22245,9883640
2016-04,Minnesota,12547,12295,24842,5303925
2016-04,Mississippi,8765,4139,12904,2967297
2016-04,Missouri,19787,12754,32541,5988927
2016-04,Montana,2989,4388,7377,989415
2016-04,Nebraska,116,1650,1766,1826341
2016-04,Nevada,5135,2793,7928,2700551
2016-04,New Hampshire,5337,3400,8737,1316470
2016-04,New Jersey,6887,3331,10218,8791894
2016-04,New Mexico,5311,3967,9278,2059179
2016-04,New York,11281,14660,25941,19378102
2016-04,North Carolina,1250,10280,11530,9535483
2016-04,North Dakota,2083,2791,4874,672591
2016-04,Ohio,32959,17664,50623,11536504
2016-04,Oklahoma,13132,8302,21434,3751351
2016-04,Oregon,13102,9998,23100,3831074
2016-04,Pennsylvania,51472,11628,63100,12702379
2016-04,Rhode Island,1149,746,1895,1052567
2016-04,South Carolina,9617,4618,14235,4625364
2016-04,South Dakota,2981,3412,6393,814180
2016-04,Tennessee,22965,12049,35014,6346105
2016-04,Texas,45339,27823,73162,25145561
2016-04,Utah,3560,3646,7206,2763885
2016-04,Vermont,1483,1557,3040,625741
2016-04,Virginia,21709,13235,34944,8001024
2016-04,Washington,15988,9698,25686,6724540
2016-04,West Virginia,6908,5417,12325,1852994
2016-04,Wisconsin,15693,13348,29041,5686986
2016-04,Wyoming,1764,1952,3716,563626
2016-03,Alabama,14372,9115,23487,4779736
2016-03,Arizona,14387,7907,22294,6392017
2016-03,Arkansas,7603,5448,13051,2915918
2016-03,California,45266,31454,76720,37253956
2016-03,Colorado,20049,12776,32825,5029196
2016-03,Connecticut,13996,4388,18384,3574097
2016-03,Delaware,2353,1611,3964,897934
2016-03,District of Columbia,74,6,80,601723
2016-03,Florida,54164,22000,76164,18801310
2016-03,Georgia,18272,8517,26789,9687653
2016-03,Idaho,3925,4208,8133,1567582
2016-03,Illinois,29052,12971,42023,12830632
2016-03,Indiana,27883,13485,41368,6483802
2016-03,Iowa,252,3012,3264,3046355
2016-03,Kansas,7683,5368,13051,2853118
2016-03,Kentucky,13816,8391,22207,4339367
2016-03,Louisiana,13738,7553,21291,4533372
2016-03,Maine,4725,3320,8045,1328361
2016-03,Maryland,4866,5363,10229,5773552
2016-03,Massachusetts,7019,3275,10294,6547629
2016-03,Michigan,18316,10145,28461,9883640
2016-03,Minnesota,13738,11323,25061,5303925
2016-03,Mississippi,11287,5697,16984,2967297
2016-03,Missouri,27030,15359,42389,5988927
2016-03,Montana,3305,4621,7926,989415
2016-03,Nebraska,132,1944,2076,1826341
2016-03,Nevada,6116,3062,9178,2700551
2016-03,New Hampshire,5912,3506,9418,1316470
2016-03,New Jersey,7346,3582,10928,8791894
2016-03,New Mexico,6497,4466,10963,2059179
2016-03,New York,12474,15134,27608,19378102
2016-03,North Carolina,1494,12263,13757,9535483
2016-03,North Dakota,1945,2711,4656,672591
2016-03,Ohio,40331,19408,59739,11536504
2016-03,Oklahoma,14892,8975,23867,3751351
2016-03,Oregon,15513,11510,27023,3831074
2016-03,Pennsylvania,60489,12299,72788,12702379
2016-03,Rhode Island,1411,858,2269,1052567
2016-03,South Carolina,12312,6138,18450,4625364
2016-03,South Dakota,3451,3588,7039,814180
2016-03,Tennessee,27951,14909,42860,6346105
2016-03,Texas,55547,31794,87341,25145561
2016-03,Utah,3772,3883,7655,2763885
2016-03,Vermont,1941,1715,3656,625741
2016-03,Virginia,26264,14622,40886,8001024
2016-03,Washington,19501,10947,30448,6724540
2016-03,West Virginia,9481,6336,15817,1852994
2016-03,Wisconsin,18439,14836,33275,5686986
2016-03,Wyoming,1995,2026,4021,563626
2016-02,Alabama,29311,15054,44365,4779736
2016-02,Arizona,16820,8782,25602,6392017
2016-02,Arkansas,10532,7028,17560,2915918
2016-02,California,44461,29486,73947,37253956
2016-02,Colorado,22384,13355,35739,5029196
2016-02,Connecticut,13316,4250,17566,3574097
2016-02,Delaware,2702,1633,4335,897934
2016-02,District of Columbia,74,7,81,601723
2016-02,Florida,62770,25228,87998,18801310
2016-02,Georgia,24534,10747,35281,9687653
2016-02,Idaho,4419,4321,8740,1567582
2016-02,Illinois,30241,13543,43784,12830632
2016-02,Indiana,32373,14947,47320,6483802
2016-02,Iowa,279,2859,3138,3046355
2016-02,Kansas,9407,6165,15572,2853118
2016-02,Kentucky,19243,10414,29657,4339367
2016-02,Louisiana,16474,9031,25505,4533372
2016-02,Maine,5426,3234,8660,1328361
2016-02,Maryland,4368,5803,10171,5773552
2016-02,Massachusetts,6253,2838,9091,6547629
2016-02,Michigan,19778,10899,30677,9883640
2016-02,Minnesota,12754,9635,22389,5303925
2016-02,Mississippi,15296,7203,22499,2967297
2016-02,Missouri,30802,16707,47509,5988927
2016-02,Montana,3779,4151,7930,989415
2016-02,Nebraska,154,2078,2232,1826341
2016-02,Nevada,6643,3115,9758,2700551
2016-02,New Hampshire,6798,3464,10262,1316470
2016-02,New Jersey,6007,3613,9620,8791894
2016-02,New Mexico,7455,5049,12504,2059179
2016-02,New York,11963,15324,27287,19378102
2016-02,North Carolina,1543,14935,16478,9535483
2016-02,North Dakota,2100,2419,4519,672591
2016-02,Ohio,45459,20745,66204,11536504
2016-02,Oklahoma,18984,10754,29738,3751351
2016-02,Oregon,17116,11665,28781,3831074
2016-02,Pennsylvania,61933,11791,73724,12702379
2016-02,Rhode Island,1288,848,2136,1052567
2016-02,South Carolina,15746,6847,22593,4625364
2016-02,South Dakota,4170,4009,8179,814180
2016-02,Tennessee,36439,18121,54560,6346105
2016-02,Texas,72584,37980,110564,25145561
2016-02,Utah,4413,4000,8413,2763885
2016-02,Vermont,2273,1681,3954,625741
2016-02,Virginia,30085,15948,46033,8001024
2016-02,Washington,20583,11991,32574,6724540
2016-02,West Virginia,10746,7436,18182,1852994
2016-02,Wisconsin,19465,12431,31896,5686986
2016-02,Wyoming,2287,2036,4323,563626
2016-01,Alabama,25445,14785,40230,4779736
2016-01,Arizona,15745,8512,24257,6392017
2016-01,Arkansas,7954,5982,13936,2915918
2016-01,California,52139,32970,85109,37253956
2016-01,Colorado,23518,13327,36845,5029196
2016-01,Connecticut,13096,4366,17462,3574097
2016-01,Delaware,2548,1608,4156,897934
2016-01,District of Columbia,52,3,55,601723
2016-01,Florida,62085,26356,88441,18801310
2016-01,Georgia,18236,9696,27932,9687653
2016-01,Idaho,4221,3820,8041,1567582
2016-01,Illinois,32112,12869,44981,12830632
2016-01,Indiana,29653,14356,44009,6483802
2016-01,Iowa,292,2600,2892,3046355
2016-01,Kansas,9196,6580,15776,2853118
2016-01,Kentucky,13847,7713,21560,4339367
2016-01,Louisiana,15485,10374,25859,4533372
2016-01,Maine,4625,3054,7679,1328361
2016-01,Maryland,3981,5541,9522,5773552
2016-01,Massachusetts,7211,3500,10711,6547629
2016-01,Michigan,17641,9995,27636,9883640
2016-01,Minnesota,12426,8624,21050,5303925
2016-01,Mississippi,10257,6713,16970,2967297
2016-01,Missouri,28980,15693,44673,5988927
2016-01,Montana,3354,3574,6928,989415
2016-01,Nebraska,179,2256,2435,1826341
2016-01,Nevada,6064,2835,8899,2700551
2016-01,New Hampshire,7146,3591,10737,1316470
2016-01,New Jersey,4520,4005,8525,8791894
2016-01,New Mexico,5921,4206,10127,2059179
2016-01,New York,12020,15461,27481,19378102
2016-01,North Carolina,1350,12950,14300,9535483
2016-01,North Dakota,2159,2554,4713,672591
2016-01,Ohio,38028,18613,56641,11536504
2016-01,Oklahoma,18688,10863,29551,3751351
2016-01,Oregon,15930,10403,26333,3831074
2016-01,Pennsylvania,57355,10224,67579,12702379
2016-01,Rhode Island,1413,898,2311,1052567
2016-01,South Carolina,12380,6289,18669,4625364
2016-01,South Dakota,3782,3815,7597,814180
2016-01,Tennessee,30411,16571,46982,6346105
2016-01,Texas,72626,38396,111022,25145561
2016-01,Utah,4662,3654,8316,2763885
2016-01,Vermont,1863,1379,3242,625741
2016-01,Virginia,27033,15699,42732,8001024
2016-01,Washington,20427,11355,31782,6724540
2016-01,West Virginia,7419,5505,12924,1852994
2016-01,Wisconsin,17969,10756,28725,5686986
2016-01,Wyoming,2181,1983,4164,563626
2015-12,Alabama,47605,33710,81315,4779736
2015-12,Arizona,25562,14725,40287,6392017
2015-12,Arkansas,13780,15241,29021,2915918
2015-12,California,74399,48762,123161,37253956
2015-12,Colorado,34653,22880,57533,5029196
2015-12,Connecticut,17828,6337,24165,3574097
2015-12,Delaware,3615,3274,6889,897934
2015-12,District of Columbia,76,3,79,601723
2015-12,Florida,86940,45769,132709,18801310
2015-12,Georgia,34974,25174,60148,9687653
2015-12,Idaho,7023,7813,14836,1567582
2015-12,Illinois,37193,20864,58057,12830632
2015-12,Indiana,44150,26105,70255,6483802
2015-12,Iowa,436,5654,6090,3046355
2015-12,Kansas,12324,12127,24451,2853118
2015-12,Kentucky,25569,19995,45564,4339367
2015-12,Louisiana,27778,25151,52929,4533372
2015-12,Maine,7493,5410,12903,1328361
2015-12,Maryland,4750,10241,14991,5773552
2015-12,Massachusetts,9398,4762,14160,6547629
2015-12,Michigan,25578,18826,44404,9883640
2015-12,Minnesota,16319,15491,31810,5303925
2015-12,Mississippi,20000,18908,38908,2967297
2015-12,Missouri,43300,30091,73391,5988927
2015-12,Montana,5902,7250,13152,989415
2015-12,Nebraska,282,4801,5083,1826341
2015-12,Nevada,9510,5088,14598,2700551
2015-12,New Hampshire,9537,5204,14741,1316470
2015-12,New Jersey,4304,6531,10835,8791894
2015-12,New Mexico,9027,7653,16680,2059179
2015-12,New York,15179,27786,42965,19378102
2015-12,North Carolina,2536,31238,33774,9535483
2015-12,North Dakota,3056,4212,7268,672591
2015-12,Ohio,60280,38256,98536,11536504
2015-12,Oklahoma,28388,21086,49474,3751351
2015-12,Oregon,23952,17062,41014,3831074
2015-12,Pennsylvania,90055,18758,108813,12702379
2015-12,Rhode Island,1663,1316,2979,1052567
2015-12,South Carolina,21019,16517,37536,4625364
2015-12,South Dakota,5240,6979,12219,814180
2015-12,Tennessee,51923,36311,88234,6346105
2015-12,Texas,107224,80247,187471,25145561
2015-12,Utah,8559,9114,17673,2763885
2015-12,Vermont,2428,2058,4486,625741
2015-12,Virginia,41097,29651,70748,8001024
2015-12,Washington,29473,18515,47988,6724540
2015-12,West Virginia,15080,13869,28949,1852994
2015-12,Wisconsin,24898,17831,42729,5686986
2015-12,Wyoming,3900,3754,7654,563626
2015-11,Alabama,23022,22650,45672,4779736
2015-11,Arizona,12382,9041,21423,6392017
2015-11,Arkansas,6359,11611,17970,2915918
2015-11,California,41181,35007,76188,37253956
2015-11,Colorado,19784,16082,35866,5029196
2015-11,Connecticut,11594,5072,16666,3574097
2015-11,Delaware,2152,2424,4576,897934
2015-11,District of Columbia,54,2,56,601723
2015-11,Florida,50796,28981,79777,18801310
2015-11,Georgia,16635,15227,31862,9687653
2015-11,Idaho,3609,5227,8836,1567582
2015-11,Illinois,24412,17227,41639,12830632
2015-11,Indiana,25519,20227,45746,6483802
2015-11,Iowa,267,4596,4863,3046355
2015-11,Kansas,7086,8702,15788,2853118
2015-11,Kentucky,12155,14847,27002,4339367
2015-11,Louisiana,14708,17368,32076,4533372
2015-11,Maine,4048,4387,8435,1328361
2015-11,Maryland,3220,8310,11530,5773552
2015-11,Massachusetts,6083,3931,10014,6547629
2015-11,Michigan,13634,17604,31238,9883640
2015-11,Minnesota,9373,14173,23546,5303925
2015-11,Mississippi,9785,13191,22976,2967297
2015-11,Missouri,21135,22852,43987,5988927
2015-11,Montana,2848,5170,8018,989415
2015-11,Nebraska,173,3724,3897,1826341
2015-11,Nevada,4889,3272,8161,2700551
2015-11,New Hampshire,4847,4165,9012,1316470
2015-11,New Jersey,3462,4704,8166,8791894
2015-11,New Mexico,5247,4974,10221,2059179
2015-11,New York,8650,23519,32169,19378102
2015-11,North Carolina,1370,20107,21477,9535483
2015-11,North Dakota,1720,3744,5464,672591
2015-11,Ohio,34878,31817,66695,11536504
2015-11,Oklahoma,15005,14753,29758,3751351
2015-11,Oregon,13586,11832,25418,3831074
2015-11,Pennsylvania,62752,16297,79049,12702379
2015-11,Rhode Island,954,932,1886,1052567
2015-11,South Carolina,11452,10393,21845,4625364
2015-11,South Dakota,2765,5484,8249,814180
2015-11,Tennessee,28815,24023,52838,6346105
2015-11,Texas,56941,51670,108611,25145561
2015-11,Utah,4314,5857,10171,2763885
2015-11,Vermont,1189,1826,3015,625741
2015-11,Virginia,24052,22348,46400,8001024
2015-11,Washington,15822,12425,28247,6724540
2015-11,West Virginia,6953,11561,18514,1852994
2015-11,Wisconsin,13700,17759,31459,5686986
2015-11,Wyoming,1745,2372,4117,563626
2015-10,Alabama,17810,14789,32599,4779736
2015-10,Arizona,10928,7308,18236,6392017
2015-10,Arkansas,5524,8839,14363,2915918
2015-10,California,37977,26151,64128,37253956
2015-10,Colorado,17059,14870,31929,5029196
2015-10,Connecticut,9306,4207,13513,3574097
2015-10,Delaware,1786,1774,3560,897934
2015-10,District of Columbia,66,0,66,601723
2015-10,Florida,45304,22587,67891,18801310
2015-10,Georgia,13192,12217,25409,9687653
2015-10,Idaho,2873,5535,8408,1567582
2015-10,Illinois,19306,12361,31667,12830632
2015-10,Indiana,18633,13859,32492,6483802
2015-10,Iowa,172,3318,3490,3046355
2015-10,Kansas,5542,5960,11502,2853118
2015-10,Kentucky,9520,10953,20473,4339367
2015-10,Louisiana,11765,14348,26113,4533372
2015-10,Maine,4028,6036,10064,1328361
2015-10,Maryland,3389,6110,9499,5773552
2015-10,Massachusetts,5226,3146,8372,6547629
2015-10,Michigan,10948,13244,24192,9883640
2015-10,Minnesota,8661,18163,26824,5303925
2015-10,Mississippi,7726,8231,15957,2967297
2015-10,Missouri,18686,18848,37534,5988927
2015-10,Montana,2701,6840,9541,989415
2015-10,Nebraska,168,2645,2813,1826341
2015-10,Nevada,4292,2549,6841,2700551
2015-10,New Hampshire,4303,3910,8213,1316470
2015-10,New Jersey,3668,3507,7175,8791894
2015-10,New Mexico,5346,4341,9687,2059179
2015-10,New York,8329,19836,28165,19378102
2015-10,North Carolina,1203,15479,16682,9535483
2015-10,North Dakota,1634,4868,6502,672591
2015-10,Ohio,27354,20613,47967,11536504
2015-10,Oklahoma,11653,10868,22521,3751351
2015-10,Oregon,13732,11626,25358,3831074
2015-10,Pennsylvania,50119,10921,61040,12702379
2015-10,Rhode Island,923,788,1711,1052567
2015-10,South Carolina,8301,7176,15477,4625364
2015-10,South Dakota,2483,6689,9172,814180
2015-10,Tennessee,24423,17480,41903,6346105
2015-10,Texas,43428,41157,84585,25145561
2015-10,Utah,2831,3827,6658,2763885
2015-10,Vermont,1183,1942,3125,625741
2015-10,Virginia,20672,17008,37680,8001024
2015-10,Washington,14937,12315,27252,6724540
2015-10,West Virginia,6286,8427,14713,1852994
2015-10,Wisconsin,12731,16908,29639,5686986
2015-10,Wyoming,1535,2274,3809,563626
2015-09,Alabama,16038,13392,29430,4779736
2015-09,Arizona,10378,7529,17907,6392017
2015-09,Arkansas,5356,6595,11951,2915918
2015-09,California,31897,24471,56368,37253956
2015-09,Colorado,15186,12898,28084,5029196
2015-09,Connecticut,8330,3566,11896,3574097
2015-09,Delaware,1503,1419,2922,897934
2015-09,District of Columbia,40,1,41,601723
2015-09,Florida,40647,20159,60806,18801310
2015-09,Georgia,12323,9659,21982,9687653
2015-09,Idaho,2782,5055,7837,1567582
2015-09,Illinois,17451,12693,30144,12830632
2015-09,Indiana,16754,11905,28659,6483802
2015-09,Iowa,191,2514,2705,3046355
2015-09,Kansas,4889,5167,10056,2853118
2015-09,Kentucky,8437,8102,16539,4339367
2015-09,Louisiana,16564,15861,32425,4533372
2015-09,Maine,3272,4190,7462,1328361
2015-09,Maryland,2615,4779,7394,5773552
2015-09,Massachusetts,4543,2442,6985,6547629
2015-09,Michigan,9276,11046,20322,9883640
2015-09,Minnesota,7639,14880,22519,5303925
2015-09,Mississippi,9974,8720,18694,2967297
2015-09,Missouri,16053,13650,29703,5988927
2015-09,Montana,2641,5616,8257,989415
2015-09,Nebraska,138,2012,2150,1826341
2015-09,Nevada,4183,2499,6682,2700551
2015-09,New Hampshire,3802,3112,6914,1316470
2015-09,New Jersey,3215,2728,5943,8791894
2015-09,New Mexico,4763,4167,8930,2059179
2015-09,New York,7532,15898,23430,19378102
2015-09,North Carolina,1131,12571,13702,9535483
2015-09,North Dakota,1399,3360,4759,672591
2015-09,Ohio,23309,16734,40043,11536504
2015-09,Oklahoma,10331,9491,19822,3751351
2015-09,Oregon,10419,11137,21556,3831074
2015-09,Pennsylvania,42205,8762,50967,12702379
2015-09,Rhode Island,816,585,1401,1052567
2015-09,South Carolina,8089,6836,14925,4625364
2015-09,South Dakota,2119,4338,6457,814180
2015-09,Tennessee,21223,14758,35981,6346105
2015-09,Texas,39567,45376,84943,25145561
2015-09,Utah,2735,4094,6829,2763885
2015-09,Vermont,1091,1464,2555,625741
2015-09,Virginia,18720,13891,32611,8001024
2015-09,Washington,13341,10892,24233,6724540
2015-09,West Virginia,5537,6493,12030,1852994
2015-09,Wisconsin,11463,13481,24944,5686986
2015-09,Wyoming,1498,2275,3773,563626
2015-08,Alabama,17991,13613,31604,4779736
2015-08,Arizona,9987,7109,17096,6392017
2015-08,Arkansas,5352,5941,11293,2915918
2015-08,California,33938,26257,60195,37253956
2015-08,Colorado,15890,12572,28462,5029196
2015-08,Connecticut,8418,3398,11816,3574097
2015-08,Delaware,1570,1392,2962,897934
2015-08,District of Columbia,65,2,67,601723
2015-08,Florida,42171,20307,62478,18801310
2015-08,Georgia,12736,9241,21977,9687653
2015-08,Idaho,2723,4163,6886,1567582
2015-08,Illinois,18088,11085,29173,12830632
2015-08,Indiana,16546,11880,28426,6483802
2015-08,Iowa,170,2288,2458,3046355
2015-08,Kansas,5378,5354,10732,2853118
2015-08,Kentucky,8238,7362,15600,4339367
2015-08,Louisiana,13992,11514,25506,4533372
2015-08,Maine,2966,3249,6215,1328361
2015-08,Maryland,2783,4315,7098,5773552
2015-08,Massachusetts,5177,2623,7800,6547629
2015-08,Michigan,9157,9431,18588,9883640
2015-08,Minnesota,7643,11193,18836,5303925
2015-08,Mississippi,7830,6651,14481,2967297
2015-08,Missouri,16501,13231,29732,5988927
2015-08,Montana,2688,4672,7360,989415
2015-08,Nebraska,140,1955,2095,1826341
2015-08,Nevada,3949,2462,6411,2700551
2015-08,New Hampshire,3870,3100,6970,1316470
2015-08,New Jersey,3555,2840,6395,8791894
2015-08,New Mexico,5029,3835,8864,2059179
2015-08,New York,7501,12410,19911,19378102
2015-08,North Carolina,1063,11789,12852,9535483
2015-08,North Dakota,1409,2855,4264,672591
2015-08,Ohio,23147,15795,38942,11536504
2015-08,Oklahoma,11425,9936,21361,3751351
2015-08,Oregon,10589,8789,19378,3831074
2015-08,Pennsylvania,41542,7972,49514,12702379
2015-08,Rhode Island,740,575,1315,1052567
2015-08,South Carolina,8487,6785,15272,4625364
2015-08,South Dakota,2233,3728,5961,814180
2015-08,Tennessee,22983,15384,38367,6346105
2015-08,Texas,41503,40561,82064,25145561
2015-08,Utah,2689,3477,6166,2763885
2015-08,Vermont,1171,1190,2361,625741
2015-08,Virginia,18252,12733,30985,8001024
2015-08,Washington,12705,9373,22078,6724540
2015-08,West Virginia,5565,5742,11307,1852994
2015-08,Wisconsin,11549,11531,23080,5686986
2015-08,Wyoming,1578,2045,3623,563626
2015-07,Alabama,17698,10276,27974,4779736
2015-07,Arizona,10226,6078,16304,6392017
2015-07,Arkansas,5216,4146,9362,2915918
2015-07,California,39980,27844,67824,37253956
2015-07,Colorado,15828,10903,26731,5029196
2015-07,Connecticut,8660,3012,11672,3574097
2015-07,Delaware,1523,1148,2671,897934
2015-07,District of Columbia,59,5,64,601723
2015-07,Florida,42570,18069,60639,18801310
2015-07,Georgia,12674,6707,19381,9687653
2015-07,Idaho,2576,3125,5701,1567582
2015-07,Illinois,18469,9243,27712,12830632
2015-07,Indiana,15416,8954,24370,6483802
2015-07,Iowa,120,1563,1683,3046355
2015-07,Kansas,5641,3849,9490,2853118
2015-07,Kentucky,8223,5645,13868,4339367
2015-07,Louisiana,11858,7371,19229,4533372
2015-07,Maine,2973,2469,5442,1328361
2015-07,Maryland,2918,3750,6668,5773552
2015-07,Massachusetts,4617,1993,6610,6547629
2015-07,Michigan,8837,6681,15518,9883640
2015-07,Minnesota,6949,7139,14088,5303925
2015-07,Mississippi,7869,4333,12202,2967297
2015-07,Missouri,16736,10260,26996,5988927
2015-07,Montana,2563,3612,6175,989415
2015-07,Nebraska,103,1332,1435,1826341
2015-07,Nevada,4074,2201,6275,2700551
2015-07,New Hampshire,3675,2517,6192,1316470
2015-07,New Jersey,3925,2538,6463,8791894
2015-07,New Mexico,4745,3325,8070,2059179
2015-07,New York,8140,9957,18097,19378102
2015-07,North Carolina,964,9325,10289,9535483
2015-07,North Dakota,1400,2040,3440,672591
2015-07,Ohio,23344,13252,36596,11536504
2015-07,Oklahoma,11162,7162,18324,3751351
2015-07,Oregon,9956,8029,17985,3831074
2015-07,Pennsylvania,38287,6885,45172,12702379
2015-07,Rhode Island,739,520,1259,1052567
2015-07,South Carolina,8486,4989,13475,4625364
2015-07,South Dakota,1926,2605,4531,814180
2015-07,Tennessee,22803,12231,35034,6346105
2015-07,Texas,41237,27981,69218,25145561
2015-07,Utah,2586,2842,5428,2763885
2015-07,Vermont,1178,939,2117,625741
2015-07,Virginia,19564,11481,31045,8001024
2015-07,Washington,12222,8220,20442,6724540
2015-07,West Virginia,5632,4503,10135,1852994
2015-07,Wisconsin,11408,7673,19081,5686986
2015-07,Wyoming,1512,1778,3290,563626
2015-06,Alabama,15299,8861,24160,4779736
2015-06,Arizona,9616,5804,15420,6392017
2015-06,Arkansas,4881,3689,8570,2915918
2015-06,California,33287,22795,56082,37253956
2015-06,Colorado,15127,10700,25827,5029196
2015-06,Connecticut,9429,3201,12630,3574097
2015-06,Delaware,1589,1169,2758,897934
2015-06,District of Columbia,45,4,49,601723
2015-06,Florida,39592,17115,56707,18801310
2015-06,Georgia,11502,6000,17502,9687653
2015-06,Idaho,2381,3063,5444,1567582
2015-06,Illinois,17666,8230,25896,12830632
2015-06,Indiana,14845,8455,23300,6483802
2015-06,Iowa,184,1634,1818,3046355
2015-06,Kansas,4610,3174,7784,2853118
2015-06,Kentucky,7280,5300,12580,4339367
2015-06,Louisiana,10584,6441,17025,4533372
2015-06,Maine,2906,2155,5061,1328361
2015-06,Maryland,2929,3776,6705,5773552
2015-06,Massachusetts,4398,2122,6520,6547629
2015-06,Michigan,8683,6668,15351,9883640
2015-06,Minnesota,7117,7084,14201,5303925
2015-06,Mississippi,6160,3422,9582,2967297
2015-06,Missouri,16285,9733,26018,5988927
2015-06,Montana,2514,3684,6198,989415
2015-06,Nebraska,142,1238,1380,1826341
2015-06,Nevada,3778,2373,6151,2700551
2015-06,New Hampshire,3745,2356,6101,1316470
2015-06,New Jersey,4261,2606,6867,8791894
2015-06,New Mexico,4546,3374,7920,2059179
2015-06,New York,8140,10400,18540,19378102
2015-06,North Carolina,1034,8587,9621,9535483
2015-06,North Dakota,1335,2008,3343,672591
2015-06,Ohio,22545,13307,35852,11536504
2015-06,Oklahoma,10529,6612,17141,3751351
2015-06,Oregon,9661,8073,17734,3831074
2015-06,Pennsylvania,39007,6733,45740,12702379
2015-06,Rhode Island,797,572,1369,1052567
2015-06,South Carolina,7693,4135,11828,4625364
2015-06,South Dakota,1866,2611,4477,814180
2015-06,Tennessee,18596,10241,28837,6346105
2015-06,Texas,43199,27650,70849,25145561
2015-06,Utah,2549,2745,5294,2763885
2015-06,Vermont,1149,890,2039,625741
2015-06,Virginia,16539,10126,26665,8001024
2015-06,Washington,12207,8243,20450,6724540
2015-06,West Virginia,5468,4455,9923,1852994
2015-06,Wisconsin,9973,7540,17513,5686986
2015-06,Wyoming,1380,1731,3111,563626
2015-05,Alabama,15629,9031,24660,4779736
2015-05,Arizona,10829,6105,16934,6392017
2015-05,Arkansas,4871,3881,8752,2915918
2015-05,California,36049,25174,61223,37253956
2015-05,Colorado,15660,11252,26912,5029196
2015-05,Connecticut,9170,3432,12602,3574097
2015-05,Delaware,1597,1197,2794,897934
2015-05,District of Columbia,50,3,53,601723
2015-05,Florida,39775,17145,56920,18801310
2015-05,Georgia,11029,5941,16970,9687653
2015-05,Idaho,2751,3569,6320,1567582
2015-05,Illinois,19457,9346,28803,12830632
2015-05,Indiana,15952,8778,24730,6483802
2015-05,Iowa,167,1781,1948,3046355
2015-05,Kansas,5200,3969,9169,2853118
2015-05,Kentucky,7321,5133,12454,4339367
2015-05,Louisiana,9916,6452,16368,4533372
2015-05,Maine,2593,2273,4866,1328361
2015-05,Maryland,2665,3972,6637,5773552
2015-05,Massachusetts,4529,2296,6825,6547629
2015-05,Michigan,9289,6839,16128,9883640
2015-05,Minnesota,8050,7795,15845,5303925
2015-05,Mississippi,6734,3669,10403,2967297
2015-05,Missouri,17111,10085,27196,5988927
2015-05,Montana,2840,4108,6948,989415
2015-05,Nebraska,104,1455,1559,1826341
2015-05,Nevada,4200,2611,6811,2700551
2015-05,New Hampshire,3813,2468,6281,1316470
2015-05,New Jersey,4118,2453,6571,8791894
2015-05,New Mexico,5143,3645,8788,2059179
2015-05,New York,7767,10516,18283,19378102
2015-05,North Carolina,1155,8393,9548,9535483
2015-05,North Dakota,1507,2349,3856,672591
2015-05,Ohio,22978,12473,35451,11536504
2015-05,Oklahoma,11082,7434,18516,3751351
2015-05,Oregon,10537,8722,19259,3831074
2015-05,Pennsylvania,38419,6825,45244,12702379
2015-05,Rhode Island,865,520,1385,1052567
2015-05,South Carolina,7725,4088,11813,4625364
2015-05,South Dakota,2260,2932,5192,814180
2015-05,Tennessee,18928,10314,29242,6346105
2015-05,Texas,44935,29899,74834,25145561
2015-05,Utah,2927,2935,5862,2763885
2015-05,Vermont,1152,921,2073,625741
2015-05,Virginia,17065,9854,26919,8001024
2015-05,Washington,12928,8555,21483,6724540
2015-05,West Virginia,5596,4499,10095,1852994
2015-05,Wisconsin,10130,8532,18662,5686986
2015-05,Wyoming,1758,1871,3629,563626
2015-04,Alabama,14929,9809,24738,4779736
2015-04,Arizona,11236,6438,17674,6392017
2015-04,Arkansas,4951,4514,9465,2915918
2015-04,California,35479,25542,61021,37253956
2015-04,Colorado,15865,11795,27660,5029196
2015-04,Connecticut,9624,3635,13259,3574097
2015-04,Delaware,1720,1228,2948,897934
2015-04,District of Columbia,49,2,51,601723
2015-04,Florida,40786,18180,58966,18801310
2015-04,Georgia,11926,6472,18398,9687653
2015-04,Idaho,2712,3727,6439,1567582
2015-04,Illinois,19123,9918,29041,12830632
2015-04,Indiana,16372,10732,27104,6483802
2015-04,Iowa,211,2163,2374,3046355
2015-04,Kansas,5754,4392,10146,2853118
2015-04,Kentucky,8012,6829,14841,4339367
2015-04,Louisiana,9998,6632,16630,4533372
2015-04,Maine,3112,2984,6096,1328361
2015-04,Maryland,3227,5116,8343,5773552
2015-04,Massachusetts,5205,2642,7847,6547629
2015-04,Michigan,10428,8134,18562,9883640
2015-04,Minnesota,9626,10862,20488,5303925
2015-04,Mississippi,6771,4061,10832,2967297
2015-04,Missouri,17715,12531,30246,5988927
2015-04,Montana,2695,4166,6861,989415
2015-04,Nebraska,134,1586,1720,1826341
2015-04,Nevada,3891,2533,6424,2700551
2015-04,New Hampshire,4277,3015,7292,1316470
2015-04,New Jersey,4462,3002,7464,8791894
2015-04,New Mexico,5084,3754,8838,2059179
2015-04,New York,9004,13499,22503,19378102
2015-04,North Carolina,950,9667,10617,9535483
2015-04,North Dakota,1530,2666,4196,672591
2015-04,Ohio,26841,16124,42965,11536504
2015-04,Oklahoma,12508,8819,21327,3751351
2015-04,Oregon,11238,9305,20543,3831074
2015-04,Pennsylvania,45156,7908,53064,12702379
2015-04,Rhode Island,931,594,1525,1052567
2015-04,South Carolina,8123,4493,12616,4625364
2015-04,South Dakota,2474,3118,5592,814180
2015-04,Tennessee,19190,11361,30551,6346105
2015-04,Texas,41412,29218,70630,25145561
2015-04,Utah,2720,3124,5844,2763885
2015-04,Vermont,1470,1477,2947,625741
2015-04,Virginia,18272,12038,30310,8001024
2015-04,Washington,14397,9063,23460,6724540
2015-04,West Virginia,6777,5845,12622,1852994
2015-04,Wisconsin,11606,12006,23612,5686986
2015-04,Wyoming,1668,1995,3663,563626
2015-03,Alabama,17870,12707,30577,4779736
2015-03,Arizona,12720,7999,20719,6392017
2015-03,Arkansas,7010,5843,12853,2915918
2015-03,California,38597,30120,68717,37253956
2015-03,Colorado,17716,14259,31975,5029196
2015-03,Connecticut,11432,4709,16141,3574097
2015-03,Delaware,2145,1741,3886,897934
2015-03,District of Columbia,62,4,66,601723
2015-03,Florida,46739,22690,69429,18801310
2015-03,Georgia,16366,9436,25802,9687653
2015-03,Idaho,3303,4416,7719,1567582
2015-03,Illinois,17517,10329,27846,12830632
2015-03,Indiana,22176,13898,36074,6483802
2015-03,Iowa,295,3211,3506,3046355
2015-03,Kansas,6823,5529,12352,2853118
2015-03,Kentucky,10407,8327,18734,4339367
2015-03,Louisiana,12506,9438,21944,4533372
2015-03,Maine,3634,3215,6849,1328361
2015-03,Maryland,3235,5268,8503,5773552
2015-03,Massachusetts,6905,3446,10351,6547629
2015-03,Michigan,13506,10617,24123,9883640
2015-03,Minnesota,10796,12244,23040,5303925
2015-03,Mississippi,8788,5791,14579,2967297
2015-03,Missouri,23164,15636,38800,5988927
2015-03,Montana,3203,4804,8007,989415
2015-03,Nebraska,123,2037,2160,1826341
2015-03,Nevada,4938,3075,8013,2700551
2015-03,New Hampshire,4853,3215,8068,1316470
2015-03,New Jersey,4924,3456,8380,8791894
2015-03,New Mexico,6149,4853,11002,2059179
2015-03,New York,9776,14574,24350,19378102
2015-03,North Carolina,1182,12154,13336,9535483
2015-03,North Dakota,2086,3302,5388,672591
2015-03,Ohio,32293,20400,52693,11536504
2015-03,Oklahoma,14307,10437,24744,3751351
2015-03,Oregon,12693,11105,23798,3831074
2015-03,Pennsylvania,56770,10644,67414,12702379
2015-03,Rhode Island,1038,743,1781,1052567
2015-03,South Carolina,9999,6364,16363,4625364
2015-03,South Dakota,3103,4041,7144,814180
2015-03,Tennessee,22617,14513,37130,6346105
2015-03,Texas,53371,36853,90224,25145561
2015-03,Utah,3186,3867,7053,2763885
2015-03,Vermont,1522,1485,3007,625741
2015-03,Virginia,22865,15230,38095,8001024
2015-03,Washington,15965,11213,27178,6724540
2015-03,West Virginia,9314,6894,16208,1852994
2015-03,Wisconsin,14792,14421,29213,5686986
2015-03,Wyoming,2023,2247,4270,563626
2015-02,Alabama,23552,14293,37845,4779736
2015-02,Arizona,13951,8211,22162,6392017
2015-02,Arkansas,8799,7037,15836,2915918
2015-02,California,37478,27480,64958,37253956
2015-02,Colorado,18284,12985,31269,5029196
2015-02,Connecticut,9806,3890,13696,3574097
2015-02,Delaware,2135,1681,3816,897934
2015-02,District of Columbia,53,0,53,601723
2015-02,Florida,52791,24827,77618,18801310
2015-02,Georgia,22438,11166,33604,9687653
2015-02,Idaho,3723,4415,8138,1567582
2015-02,Illinois,23614,13379,36993,12830632
2015-02,Indiana,24373,13650,38023,6483802
2015-02,Iowa,268,2984,3252,3046355
2015-02,Kansas,7694,6109,13803,2853118
2015-02,Kentucky,13909,9486,23395,4339367
2015-02,Louisiana,13427,9717,23144,4533372
2015-02,Maine,2962,2545,5507,1328361
2015-02,Maryland,2815,4670,7485,5773552
2015-02,Massachusetts,4621,2174,6795,6547629
2015-02,Michigan,13093,9906,22999,9883640
2015-02,Minnesota,9846,9858,19704,5303925
2015-02,Mississippi,11559,6964,18523,2967297
2015-02,Missouri,26048,15858,41906,5988927
2015-02,Montana,3178,4248,7426,989415
2015-02,Nebraska,133,2156,2289,1826341
2015-02,Nevada,5338,3100,8438,2700551
2015-02,New Hampshire,4184,2529,6713,1316470
2015-02,New Jersey,4101,3005,7106,8791894
2015-02,New Mexico,6039,4625,10664,2059179
2015-02,New York,8512,13343,21855,19378102
2015-02,North Carolina,1364,14638,16002,9535483
2015-02,North Dakota,1862,2783,4645,672591
2015-02,Ohio,34137,18836,52973,11536504
2015-02,Oklahoma,16251,10864,27115,3751351
2015-02,Oregon,13230,10932,24162,3831074
2015-02,Pennsylvania,51886,8727,60613,12702379
2015-02,Rhode Island,922,635,1557,1052567
2015-02,South Carolina,13831,7072,20903,4625364
2015-02,South Dakota,3449,4167,7616,814180
2015-02,Tennessee,27069,16763,43832,6346105
2015-02,Texas,60204,39798,100002,25145561
2015-02,Utah,3668,4018,7686,2763885
2015-02,Vermont,1649,1421,3070,625741
2015-02,Virginia,23999,15237,39236,8001024
2015-02,Washington,15771,11434,27205,6724540
2015-02,West Virginia,9538,7719,17257,1852994
2015-02,Wisconsin,13332,12361,25693,5686986
2015-02,Wyoming,2131,2092,4223,563626
2015-01,Alabama,16291,12944,29235,4779736
2015-01,Arizona,10585,6808,17393,6392017
2015-01,Arkansas,5295,5760,11055,2915918
2015-01,California,37560,23524,61084,37253956
2015-01,Colorado,15739,11932,27671,5029196
2015-01,Connecticut,9910,3891,13801,3574097
2015-01,Delaware,1910,1596,3506,897934
2015-01,District of Columbia,55,6,61,601723
2015-01,Florida,43909,21939,65848,18801310
2015-01,Georgia,13650,9280,22930,9687653
2015-01,Idaho,2568,3342,5910,1567582
2015-01,Illinois,20682,12203,32885,12830632
2015-01,Indiana,18433,11935,30368,6483802
2015-01,Iowa,197,2486,2683,3046355
2015-01,Kansas,5724,5577,11301,2853118
2015-01,Kentucky,9629,7663,17292,4339367
2015-01,Louisiana,10760,10358,21118,4533372
2015-01,Maine,2617,2285,4902,1328361
2015-01,Maryland,2542,4795,7337,5773552
2015-01,Massachusetts,5139,2568,7707,6547629
2015-01,Michigan,9260,7923,17183,9883640
2015-01,Minnesota,8181,7949,16130,5303925
2015-01,Mississippi,6798,6220,13018,2967297
2015-01,Missouri,21243,13943,35186,5988927
2015-01,Montana,2204,3380,5584,989415
2015-01,Nebraska,169,2057,2226,1826341
2015-01,Nevada,3936,2553,6489,2700551
2015-01,New Hampshire,4097,2652,6749,1316470
2015-01,New Jersey,3854,3163,7017,8791894
2015-01,New Mexico,4548,3689,8237,2059179
2015-01,New York,9002,12478,21480,19378102
2015-01,North Carolina,1291,13043,14334,9535483
2015-01,North Dakota,1672,2793,4465,672591
2015-01,Ohio,26268,16186,42454,11536504
2015-01,Oklahoma,13234,9811,23045,3751351
2015-01,Oregon,10601,8766,19367,3831074
2015-01,Pennsylvania,44966,7800,52766,12702379
2015-01,Rhode Island,886,622,1508,1052567
2015-01,South Carolina,8767,6156,14923,4625364
2015-01,South Dakota,2399,3631,6030,814180
2015-01,Tennessee,22197,15007,37204,6346105
2015-01,Texas,44153,36397,80550,25145561
2015-01,Utah,2923,3317,6240,2763885
2015-01,Vermont,1171,1081,2252,625741
2015-01,Virginia,21023,14433,35456,8001024
2015-01,Washington,13781,9419,23200,6724540
2015-01,West Virginia,6881,5876,12757,1852994
2015-01,Wisconsin,9703,9221,18924,5686986
2015-01,Wyoming,1646,1830,3476,563626
2014-12,Alabama,23630,29449,53079,4779736
2014-12,Arizona,14200,11509,25709,6392017
2014-12,Arkansas,8260,14121,22381,2915918
2014-12,California,66770,47409,114179,37253956
2014-12,Colorado,20924,19494,40418,5029196
2014-12,Connecticut,11516,5542,17058,3574097
2014-12,Delaware,2320,3079,5399,897934
2014-12,District of Columbia,50,3,53,601723
2014-12,Florida,50412,37098,87510,18801310
2014-12,Georgia,19541,22872,42413,9687653
2014-12,Idaho,4260,6913,11173,1567582
2014-12,Illinois,24857,19709,44566,12830632
2014-12,Indiana,23399,21186,44585,6483802
2014-12,Iowa,260,5574,5834,3046355
2014-12,Kansas,7333,10739,18072,2853118
2014-12,Kentucky,14308,17629,31937,4339367
2014-12,Louisiana,15337,25507,40844,4533372
2014-12,Maine,3653,4701,8354,1328361
2014-12,Maryland,2839,8357,11196,5773552
2014-12,Massachusetts,5486,3263,8749,6547629
2014-12,Michigan,11860,15576,27436,9883640
2014-12,Minnesota,9357,13082,22439,5303925
2014-12,Mississippi,10726,17253,27979,2967297
2014-12,Missouri,27713,25507,53220,5988927
2014-12,Montana,3913,6802,10715,989415
2014-12,Nebraska,184,4455,4639,1826341
2014-12,Nevada,5202,4356,9558,2700551
2014-12,New Hampshire,5059,4122,9181,1316470
2014-12,New Jersey,3796,4768,8564,8791894
2014-12,New Mexico,6575,6721,13296,2059179
2014-12,New York,9349,21403,30752,19378102
2014-12,North Carolina,1745,27082,28827,9535483
2014-12,North Dakota,2020,4018,6038,672591
2014-12,Ohio,35658,30752,66410,11536504
2014-12,Oklahoma,19055,20488,39543,3751351
2014-12,Oregon,14346,13994,28340,3831074
2014-12,Pennsylvania,61828,12737,74565,12702379
2014-12,Rhode Island,895,894,1789,1052567
2014-12,South Carolina,11905,14320,26225,4625364
2014-12,South Dakota,3098,5897,8995,814180
2014-12,Tennessee,30117,30298,60415,6346105
2014-12,Texas,66280,78321,144601,25145561
2014-12,Utah,4744,8018,12762,2763885
2014-12,Vermont,1306,1715,3021,625741
2014-12,Virginia,24410,24225,48635,8001024
2014-12,Washington,19476,15253,34729,6724540
2014-12,West Virginia,9844,12767,22611,1852994
2014-12,Wisconsin,12139,14806,26945,5686986
2014-12,Wyoming,2729,3383,6112,563626
2014-11,Alabama,16301,22502,38803,4779736
2014-11,Arizona,9974,9362,19336,6392017
2014-11,Arkansas,5277,12356,17633,2915918
2014-11,California,43779,34964,78743,37253956
2014-11,Colorado,15478,16152,31630,5029196
2014-11,Connecticut,9106,4957,14063,3574097
2014-11,Delaware,1846,2649,4495,897934
2014-11,District of Columbia,43,2,45,601723
2014-11,Florida,39126,30723,69849,18801310
2014-11,Georgia,12951,16489,29440,9687653
2014-11,Idaho,2611,5013,7624,1567582
2014-11,Illinois,19282,18280,37562,12830632
2014-11,Indiana,16681,20381,37062,6483802
2014-11,Iowa,174,5018,5192,3046355
2014-11,Kansas,5428,9622,15050,2853118
2014-11,Kentucky,8807,15632,24439,4339367
2014-11,Louisiana,10660,19375,30035,4533372
2014-11,Maine,2356,4426,6782,1328361
2014-11,Maryland,2290,8896,11186,5773552
2014-11,Massachusetts,4698,3370,8068,6547629
2014-11,Michigan,8752,17256,26008,9883640
2014-11,Minnesota,6462,13470,19932,5303925
2014-11,Mississippi,6019,13482,19501,2967297
2014-11,Missouri,23419,26565,49984,5988927
2014-11,Montana,2442,5296,7738,989415
2014-11,Nebraska,135,3757,3892,1826341
2014-11,Nevada,3807,3308,7115,2700551
2014-11,New Hampshire,3838,3784,7622,1316470
2014-11,New Jersey,3141,4357,7498,8791894
2014-11,New Mexico,4734,5370,10104,2059179
2014-11,New York,6959,22126,29085,19378102
2014-11,North Carolina,1210,22312,23522,9535483
2014-11,North Dakota,1447,4023,5470,672591
2014-11,Ohio,26893,32001,58894,11536504
2014-11,Oklahoma,14060,17558,31618,3751351
2014-11,Oregon,10465,11486,21951,3831074
2014-11,Pennsylvania,57010,13907,70917,12702379
2014-11,Rhode Island,836,796,1632,1052567
2014-11,South Carolina,8668,10869,19537,4625364
2014-11,South Dakota,2231,5750,7981,814180
2014-11,Tennessee,21010,24913,45923,6346105
2014-11,Texas,47340,58551,105891,25145561
2014-11,Utah,3189,5890,9079,2763885
2014-11,Vermont,932,1814,2746,625741
2014-11,Virginia,19685,23164,42849,8001024
2014-11,Washington,16080,13996,30076,6724540
2014-11,West Virginia,6057,12780,18837,1852994
2014-11,Wisconsin,8645,16950,25595,5686986
2014-11,Wyoming,1675,2637,4312,563626
2014-10,Alabama,13930,14643,28573,4779736
2014-10,Arizona,9557,7966,17523,6392017
2014-10,Arkansas,5164,9255,14419,2915918
2014-10,California,42829,30607,73436,37253956
2014-10,Colorado,14704,14649,29353,5029196
2014-10,Connecticut,8934,4654,13588,3574097
2014-10,Delaware,1562,1941,3503,897934
2014-10,District of Columbia,50,1,51,601723
2014-10,Florida,38428,23668,62096,18801310
2014-10,Georgia,11239,12696,23935,9687653
2014-10,Idaho,2351,5239,7590,1567582
2014-10,Illinois,17927,14023,31950,12830632
2014-10,Indiana,16054,15005,31059,6483802
2014-10,Iowa,176,3667,3843,3046355
2014-10,Kansas,4725,6092,10817,2853118
2014-10,Kentucky,8530,11463,19993,4339367
2014-10,Louisiana,9658,15343,25001,4533372
2014-10,Maine,2800,6552,9352,1328361
2014-10,Maryland,2410,5964,8374,5773552
2014-10,Massachusetts,4902,3343,8245,6547629
2014-10,Michigan,8642,13602,22244,9883640
2014-10,Minnesota,7461,17386,24847,5303925
2014-10,Mississippi,6024,8325,14349,2967297
2014-10,Missouri,18128,20255,38383,5988927
2014-10,Montana,2651,6683,9334,989415
2014-10,Nebraska,130,2698,2828,1826341
2014-10,Nevada,3830,2880,6710,2700551
2014-10,New Hampshire,3975,4109,8084,1316470
2014-10,New Jersey,3583,3736,7319,8791894
2014-10,New Mexico,4910,4780,9690,2059179
2014-10,New York,8190,21900,30090,19378102
2014-10,North Carolina,1155,15491,16646,9535483
2014-10,North Dakota,1598,5306,6904,672591
2014-10,Ohio,25552,22111,47663,11536504
2014-10,Oklahoma,12353,12430,24783,3751351
2014-10,Oregon,9939,10701,20640,3831074
2014-10,Pennsylvania,50150,10758,60908,12702379
2014-10,Rhode Island,907,806,1713,1052567
2014-10,South Carolina,7251,7633,14884,4625364
2014-10,South Dakota,2172,6508,8680,814180
2014-10,Tennessee,19184,17453,36637,6346105
2014-10,Texas,39725,44864,84589,25145561
2014-10,Utah,2335,4064,6399,2763885
2014-10,Vermont,1130,1853,2983,625741
2014-10,Virginia,18009,17273,35282,8001024
2014-10,Washington,13942,12017,25959,6724540
2014-10,West Virginia,6080,9459,15539,1852994
2014-10,Wisconsin,10459,16475,26934,5686986
2014-10,Wyoming,1597,2630,4227,563626
2014-09,Alabama,12337,13130,25467,4779736
2014-09,Arizona,8689,7451,16140,6392017
2014-09,Arkansas,4074,6480,10554,2915918
2014-09,California,37720,28503,66223,37253956
2014-09,Colorado,13033,12658,25691,5029196
2014-09,Connecticut,7785,3660,11445,3574097
2014-09,Delaware,1370,1688,3058,897934
2014-09,District of Columbia,47,1,48,601723
2014-09,Florida,37253,21661,58914,18801310
2014-09,Georgia,9973,9497,19470,9687653
2014-09,Idaho,2367,4956,7323,1567582
2014-09,Illinois,16060,12191,28251,12830632
2014-09,Indiana,13876,12326,26202,6483802
2014-09,Iowa,178,2660,2838,3046355
2014-09,Kansas,3935,5343,9278,2853118
2014-09,Kentucky,6912,8077,14989,4339367
2014-09,Louisiana,11352,16638,27990,4533372
2014-09,Maine,2440,4596,7036,1328361
2014-09,Maryland,2282,4797,7079,5773552
2014-09,Massachusetts,4098,2420,6518,6547629
2014-09,Michigan,7668,12051,19719,9883640
2014-09,Minnesota,6621,15768,22389,5303925
2014-09,Mississippi,7427,8847,16274,2967297
2014-09,Missouri,14837,14838,29675,5988927
2014-09,Montana,2562,5273,7835,989415
2014-09,Nebraska,90,2156,2246,1826341
2014-09,Nevada,3517,2803,6320,2700551
2014-09,New Hampshire,3466,3192,6658,1316470
2014-09,New Jersey,3492,2854,6346,8791894
2014-09,New Mexico,4080,4168,8248,2059179
2014-09,New York,7350,16835,24185,19378102
2014-09,North Carolina,926,12314,13240,9535483
2014-09,North Dakota,1389,3798,5187,672591
2014-09,Ohio,20852,17783,38635,11536504
2014-09,Oklahoma,10040,10567,20607,3751351
2014-09,Oregon,9089,10389,19478,3831074
2014-09,Pennsylvania,42506,8823,51329,12702379
2014-09,Rhode Island,779,627,1406,1052567
2014-09,South Carolina,6192,6127,12319,4625364
2014-09,South Dakota,2006,4479,6485,814180
2014-09,Tennessee,16841,14442,31283,6346105
2014-09,Texas,34837,46899,81736,25145561
2014-09,Utah,2458,4059,6517,2763885
2014-09,Vermont,1033,1604,2637,625741
2014-09,Virginia,16028,14835,30863,8001024
2014-09,Washington,11366,10589,21955,6724540
2014-09,West Virginia,5203,7365,12568,1852994
2014-09,Wisconsin,9224,13579,22803,5686986
2014-09,Wyoming,1514,2483,3997,563626
2014-08,Alabama,13082,11806,24888,4779736
2014-08,Arizona,9189,7159,16348,6392017
2014-08,Arkansas,4075,5296,9371,2915918
2014-08,California,38710,30590,69300,37253956
2014-08,Colorado,14088,12531,26619,5029196
2014-08,Connecticut,6001,2553,8554,3574097
2014-08,Delaware,1427,1623,3050,897934
2014-08,District of Columbia,44,3,47,601723
2014-08,Florida,37260,19794,57054,18801310
2014-08,Georgia,10608,8358,18966,9687653
2014-08,Idaho,2298,3968,6266,1567582
2014-08,Illinois,16532,12191,28723,12830632
2014-08,Indiana,15459,12168,27627,6483802
2014-08,Iowa,117,2205,2322,3046355
2014-08,Kansas,3930,4968,8898,2853118
2014-08,Kentucky,7230,7382,14612,4339367
2014-08,Louisiana,10024,10791,20815,4533372
2014-08,Maine,2299,3387,5686,1328361
2014-08,Maryland,2393,4587,6980,5773552
2014-08,Massachusetts,4868,2726,7594,6547629
2014-08,Michigan,7886,9867,17753,9883640
2014-08,Minnesota,6595,11540,18135,5303925
2014-08,Mississippi,5690,6078,11768,2967297
2014-08,Missouri,17329,14418,31747,5988927
2014-08,Montana,2712,4427,7139,989415
2014-08,Nebraska,81,1878,1959,1826341
2014-08,Nevada,3749,2720,6469,2700551
2014-08,New Hampshire,3616,3162,6778,1316470
2014-08,New Jersey,3653,3035,6688,8791894
2014-08,New Mexico,4498,3949,8447,2059179
2014-08,New York,7025,13388,20413,19378102
2014-08,North Carolina,930,12038,12968,9535483
2014-08,North Dakota,1353,2979,4332,672591
2014-08,Ohio,20742,16787,37529,11536504
2014-08,Oklahoma,10714,9635,20349,3751351
2014-08,Oregon,8476,8157,16633,3831074
2014-08,Pennsylvania,40384,8958,49342,12702379
2014-08,Rhode Island,790,683,1473,1052567
2014-08,South Carolina,6621,5989,12610,4625364
2014-08,South Dakota,1972,3693,5665,814180
2014-08,Tennessee,17136,14233,31369,6346105
2014-08,Texas,38172,43507,81679,25145561
2014-08,Utah,2364,3132,5496,2763885
2014-08,Vermont,1020,1177,2197,625741
2014-08,Virginia,16034,13675,29709,8001024
2014-08,Washington,11570,9239,20809,6724540
2014-08,West Virginia,5236,5986,11222,1852994
2014-08,Wisconsin,8526,11849,20375,5686986
2014-08,Wyoming,1517,1964,3481,563626
2014-07,Alabama,11554,9544,21098,4779736
2014-07,Arizona,8216,5610,13826,6392017
2014-07,Arkansas,3668,3928,7596,2915918
2014-07,California,34912,24482,59394,37253956
2014-07,Colorado,13288,10489,23777,5029196
2014-07,Connecticut,4141,1489,5630,3574097
2014-07,Delaware,1301,1333,2634,897934
2014-07,District of Columbia,44,4,48,601723
2014-07,Florida,33878,17356,51234,18801310
2014-07,Georgia,8998,5971,14969,9687653
2014-07,Idaho,1970,2823,4793,1567582
2014-07,Illinois,15798,9607,25405,12830632
2014-07,Indiana,13475,9126,22601,6483802
2014-07,Iowa,119,1606,1725,3046355
2014-07,Kansas,3884,3623,7507,2853118
2014-07,Kentucky,6375,5428,11803,4339367
2014-07,Louisiana,7931,7199,15130,4533372
2014-07,Maine,1995,2381,4376,1328361
2014-07,Maryland,1953,3534,5487,5773552
2014-07,Massachusetts,3922,2154,6076,6547629
2014-07,Michigan,7133,6479,13612,9883640
2014-07,Minnesota,6012,7192,13204,5303925
2014-07,Mississippi,4733,3874,8607,2967297
2014-07,Missouri,12678,9729,22407,5988927
2014-07,Montana,2111,3279,5390,989415
2014-07,Nebraska,75,1241,1316,1826341
2014-07,Nevada,3359,2279,5638,2700551
2014-07,New Hampshire,3126,2456,5582,1316470
2014-07,New Jersey,3989,2681,6670,8791894
2014-07,New Mexico,3803,3193,6996,2059179
2014-07,New York,7428,9573,17001,19378102
2014-07,North Carolina,787,8442,9229,9535483
2014-07,North Dakota,1150,2145,3295,672591
2014-07,Ohio,19770,14202,33972,11536504
2014-07,Oklahoma,9523,7517,17040,3751351
2014-07,Oregon,7888,6998,14886,3831074
2014-07,Pennsylvania,34544,6543,41087,12702379
2014-07,Rhode Island,686,564,1250,1052567
2014-07,South Carolina,5453,4095,9548,4625364
2014-07,South Dakota,1816,2559,4375,814180
2014-07,Tennessee,15442,10414,25856,6346105
2014-07,Texas,32736,28145,60881,25145561
2014-07,Utah,1990,2532,4522,2763885
2014-07,Vermont,916,888,1804,625741
2014-07,Virginia,15727,11605,27332,8001024
2014-07,Washington,10715,7606,18321,6724540
2014-07,West Virginia,4847,4587,9434,1852994
2014-07,Wisconsin,7883,7746,15629,5686986
2014-07,Wyoming,1425,1691,3116,563626
2014-06,Alabama,11437,10279,21716,4779736
2014-06,Arizona,8507,5496,14003,6392017
2014-06,Arkansas,3859,3788,7647,2915918
2014-06,California,34232,24557,58789,37253956
2014-06,Colorado,12549,9343,21892,5029196
2014-06,Connecticut,4293,1647,5940,3574097
2014-06,Delaware,1451,1146,2597,897934
2014-06,District of Columbia,21,1,22,601723
2014-06,Florida,33636,17047,50683,18801310
2014-06,Georgia,9625,6006,15631,9687653
2014-06,Idaho,2220,3190,5410,1567582
2014-06,Illinois,15406,8740,24146,12830632
2014-06,Indiana,13069,8702,21771,6483802
2014-06,Iowa,146,1614,1760,3046355
2014-06,Kansas,3682,3604,7286,2853118
2014-06,Kentucky,6061,5196,11257,4339367
2014-06,Louisiana,9220,6868,16088,4533372
2014-06,Maine,2065,2185,4250,1328361
2014-06,Maryland,2383,3641,6024,5773552
2014-06,Massachusetts,4060,2021,6081,6547629
2014-06,Michigan,7041,6044,13085,9883640
2014-06,Minnesota,6592,6796,13388,5303925
2014-06,Mississippi,4596,3664,8260,2967297
2014-06,Missouri,13225,9673,22898,5988927
2014-06,Montana,2469,3630,6099,989415
2014-06,Nebraska,89,1144,1233,1826341
2014-06,Nevada,3695,2418,6113,2700551
2014-06,New Hampshire,3214,2561,5775,1316470
2014-06,New Jersey,4018,2493,6511,8791894
2014-06,New Mexico,4237,3269,7506,2059179
2014-06,New York,6991,9201,16192,19378102
2014-06,North Carolina,751,8702,9453,9535483
2014-06,North Dakota,1191,2114,3305,672591
2014-06,Ohio,18471,13177,31648,11536504
2014-06,Oklahoma,9705,7568,17273,3751351
2014-06,Oregon,8731,7689,16420,3831074
2014-06,Pennsylvania,33261,6077,39338,12702379
2014-06,Rhode Island,657,487,1144,1052567
2014-06,South Carolina,5911,3745,9656,4625364
2014-06,South Dakota,1794,2468,4262,814180
2014-06,Tennessee,14563,10004,24567,6346105
2014-06,Texas,34426,27426,61852,25145561
2014-06,Utah,2182,2654,4836,2763885
2014-06,Vermont,867,787,1654,625741
2014-06,Virginia,14711,11017,25728,8001024
2014-06,Washington,11690,8253,19943,6724540
2014-06,West Virginia,4786,4290,9076,1852994
2014-06,Wisconsin,7922,7111,15033,5686986
2014-06,Wyoming,1503,1774,3277,563626
2014-05,Alabama,12872,8807,21679,4779736
2014-05,Arizona,9112,6065,15177,6392017
2014-05,Arkansas,3931,3869,7800,2915918
2014-05,California,38192,26630,64822,37253956
2014-05,Colorado,13775,10818,24593,5029196
2014-05,Connecticut,4837,1900,6737,3574097
2014-05,Delaware,1790,1671,3461,897934
2014-05,District of Columbia,29,2,31,601723
2014-05,Florida,35254,17504,52758,18801310
2014-05,Georgia,10127,6051,16178,9687653
2014-05,Idaho,2436,3399,5835,1567582
2014-05,Illinois,17848,9308,27156,12830632
2014-05,Indiana,15395,9454,24849,6483802
2014-05,Iowa,120,1659,1779,3046355
2014-05,Kansas,4155,3779,7934,2853118
2014-05,Kentucky,6668,5294,11962,4339367
2014-05,Louisiana,9196,6921,16117,4533372
2014-05,Maine,2546,2571,5117,1328361
2014-05,Maryland,2532,3877,6409,5773552
2014-05,Massachusetts,4713,2294,7007,6547629
2014-05,Michigan,8422,6988,15410,9883640
2014-05,Minnesota,7285,7633,14918,5303925
2014-05,Mississippi,5337,3706,9043,2967297
2014-05,Missouri,14385,9810,24195,5988927
2014-05,Montana,2516,3735,6251,989415
2014-05,Nebraska,107,1323,1430,1826341
2014-05,Nevada,3740,2535,6275,2700551
2014-05,New Hampshire,3831,2802,6633,1316470
2014-05,New Jersey,4856,2871,7727,8791894
2014-05,New Mexico,4577,3520,8097,2059179
2014-05,New York,8008,10682,18690,19378102
2014-05,North Carolina,767,8557,9324,9535483
2014-05,North Dakota,1496,2549,4045,672591
2014-05,Ohio,21891,14553,36444,11536504
2014-05,Oklahoma,9927,7324,17251,3751351
2014-05,Oregon,9636,8199,17835,3831074
2014-05,Pennsylvania,38001,6871,44872,12702379
2014-05,Rhode Island,745,592,1337,1052567
2014-05,South Carolina,6444,3875,10319,4625364
2014-05,South Dakota,1992,2659,4651,814180
2014-05,Tennessee,15607,10039,25646,6346105
2014-05,Texas,37264,29032,66296,25145561
2014-05,Utah,2454,2854,5308,2763885
2014-05,Vermont,977,1014,1991,625741
2014-05,Virginia,15597,11102,26699,8001024
2014-05,Washington,12517,8554,21071,6724540
2014-05,West Virginia,5563,4878,10441,1852994
2014-05,Wisconsin,9269,8182,17451,5686986
2014-05,Wyoming,1732,1972,3704,563626
2014-04,Alabama,13842,10285,24127,4779736
2014-04,Arizona,10229,6786,17015,6392017
2014-04,Arkansas,4509,4705,9214,2915918
2014-04,California,40847,29602,70449,37253956
2014-04,Colorado,14888,11741,26629,5029196
2014-04,Connecticut,4885,2714,7599,3574097
2014-04,Delaware,1449,957,2406,897934
2014-04,District of Columbia,29,5,34,601723
2014-04,Florida,37470,19213,56683,18801310
2014-04,Georgia,10794,6894,17688,9687653
2014-04,Idaho,2524,3506,6030,1567582
2014-04,Illinois,21131,11333,32464,12830632
2014-04,Indiana,16956,11235,28191,6483802
2014-04,Iowa,183,2379,2562,3046355
2014-04,Kansas,4961,4849,9810,2853118
2014-04,Kentucky,7460,6916,14376,4339367
2014-04,Louisiana,9614,7205,16819,4533372
2014-04,Maine,3028,3280,6308,1328361
2014-04,Maryland,4065,4397,8462,5773552
2014-04,Massachusetts,5277,2791,8068,6547629
2014-04,Michigan,10199,8974,19173,9883640
2014-04,Minnesota,9635,11501,21136,5303925
2014-04,Mississippi,5471,4232,9703,2967297
2014-04,Missouri,16394,13060,29454,5988927
2014-04,Montana,2846,4260,7106,989415
2014-04,Nebraska,114,1530,1644,1826341
2014-04,Nevada,4030,2969,6999,2700551
2014-04,New Hampshire,4324,3113,7437,1316470
2014-04,New Jersey,5108,3208,8316,8791894
2014-04,New Mexico,4751,3793,8544,2059179
2014-04,New York,8812,14214,23026,19378102
2014-04,North Carolina,899,9966,10865,9535483
2014-04,North Dakota,1931,3158,5089,672591
2014-04,Ohio,26196,18183,44379,11536504
2014-04,Oklahoma,11910,9474,21384,3751351
2014-04,Oregon,10106,9347,19453,3831074
2014-04,Pennsylvania,44546,7942,52488,12702379
2014-04,Rhode Island,846,664,1510,1052567
2014-04,South Carolina,7753,4816,12569,4625364
2014-04,South Dakota,2219,3235,5454,814180
2014-04,Tennessee,16972,11316,28288,6346105
2014-04,Texas,38657,30379,69036,25145561
2014-04,Utah,2560,3154,5714,2763885
2014-04,Vermont,1485,1527,3012,625741
2014-04,Virginia,17184,13113,30297,8001024
2014-04,Washington,13876,9961,23837,6724540
2014-04,West Virginia,6345,6087,12432,1852994
2014-04,Wisconsin,12764,12744,25508,5686986
2014-04,Wyoming,2005,2209,4214,563626
2014-03,Alabama,17289,13141,30430,4779736
2014-03,Arizona,12720,8253,20973,6392017
2014-03,Arkansas,6054,5924,11978,2915918
2014-03,California,45089,34352,79441,37253956
2014-03,Colorado,18478,13652,32130,5029196
2014-03,Connecticut,6563,12310,18873,3574097
2014-03,Delaware,1809,1219,3028,897934
2014-03,District of Columbia,45,3,48,601723
2014-03,Florida,42745,23125,65870,18801310
2014-03,Georgia,15033,10064,25097,9687653
2014-03,Idaho,3166,4346,7512,1567582
2014-03,Illinois,26637,15182,41819,12830632
2014-03,Indiana,23024,15040,38064,6483802
2014-03,Iowa,237,3580,3817,3046355
2014-03,Kansas,6240,6138,12378,2853118
2014-03,Kentucky,10541,8970,19511,4339367
2014-03,Louisiana,12132,9994,22126,4533372
2014-03,Maine,3478,3487,6965,1328361
2014-03,Maryland,8197,5712,13909,5773552
2014-03,Massachusetts,6794,3607,10401,6547629
2014-03,Michigan,13134,11534,24668,9883640
2014-03,Minnesota,10604,12475,23079,5303925
2014-03,Mississippi,7582,6093,13675,2967297
2014-03,Missouri,20739,15823,36562,5988927
2014-03,Montana,3307,4683,7990,989415
2014-03,Nebraska,121,2079,2200,1826341
2014-03,Nevada,4727,3495,8222,2700551
2014-03,New Hampshire,5060,3695,8755,1316470
2014-03,New Jersey,5486,4034,9520,8791894
2014-03,New Mexico,5928,5200,11128,2059179
2014-03,New York,9717,15665,25382,19378102
2014-03,North Carolina,1054,13571,14625,9535483
2014-03,North Dakota,1966,3397,5363,672591
2014-03,Ohio,32656,21426,54082,11536504
2014-03,Oklahoma,13697,11271,24968,3751351
2014-03,Oregon,12411,11829,24240,3831074
2014-03,Pennsylvania,57940,10351,68291,12702379
2014-03,Rhode Island,1106,912,2018,1052567
2014-03,South Carolina,10077,6225,16302,4625364
2014-03,South Dakota,2857,4061,6918,814180
2014-03,Tennessee,19944,15014,34958,6346105
2014-03,Texas,49169,38758,87927,25145561
2014-03,Utah,3322,3888,7210,2763885
2014-03,Vermont,1615,1563,3178,625741
2014-03,Virginia,23015,16781,39796,8001024
2014-03,Washington,16516,12072,28588,6724540
2014-03,West Virginia,8542,7716,16258,1852994
2014-03,Wisconsin,14797,15233,30030,5686986
2014-03,Wyoming,2267,2379,4646,563626
2014-02,Alabama,19710,14439,34149,4779736
2014-02,Arizona,13149,8294,21443,6392017
2014-02,Arkansas,7312,7375,14687,2915918
2014-02,California,39048,29728,68776,37253956
2014-02,Colorado,17215,13037,30252,5029196
2014-02,Connecticut,5246,11351,16597,3574097
2014-02,Delaware,1660,1022,2682,897934
2014-02,District of Columbia,25,2,27,601723
2014-02,Florida,46802,25174,71976,18801310
2014-02,Georgia,17171,10809,27980,9687653
2014-02,Idaho,3263,4333,7596,1567582
2014-02,Illinois,23448,13449,36897,12830632
2014-02,Indiana,22970,14166,37136,6483802
2014-02,Iowa,206,2939,3145,3046355
2014-02,Kansas,7199,6496,13695,2853118
2014-02,Kentucky,13082,10425,23507,4339367
2014-02,Louisiana,13147,10479,23626,4533372
2014-02,Maine,3221,3082,6303,1328361
2014-02,Maryland,10156,5446,15602,5773552
2014-02,Massachusetts,5471,2679,8150,6547629
2014-02,Michigan,11886,9984,21870,9883640
2014-02,Minnesota,8845,9013,17858,5303925
2014-02,Mississippi,9222,6691,15913,2967297
2014-02,Missouri,21678,16291,37969,5988927
2014-02,Montana,2798,4003,6801,989415
2014-02,Nebraska,113,2129,2242,1826341
2014-02,Nevada,5089,3284,8373,2700551
2014-02,New Hampshire,4270,3080,7350,1316470
2014-02,New Jersey,4327,3290,7617,8791894
2014-02,New Mexico,5979,4999,10978,2059179
2014-02,New York,8553,13614,22167,19378102
2014-02,North Carolina,1082,15014,16096,9535483
2014-02,North Dakota,1910,2814,4724,672591
2014-02,Ohio,32864,19732,52596,11536504
2014-02,Oklahoma,15122,11260,26382,3751351
2014-02,Oregon,12334,10825,23159,3831074
2014-02,Pennsylvania,47511,10231,57742,12702379
2014-02,Rhode Island,996,718,1714,1052567
2014-02,South Carolina,11484,6181,17665,4625364
2014-02,South Dakota,3008,4013,7021,814180
2014-02,Tennessee,25694,17965,43659,6346105
2014-02,Texas,55417,41550,96967,25145561
2014-02,Utah,3584,3976,7560,2763885
2014-02,Vermont,1662,1337,2999,625741
2014-02,Virginia,24248,16694,40942,8001024
2014-02,Washington,15785,12011,27796,6724540
2014-02,West Virginia,8737,7936,16673,1852994
2014-02,Wisconsin,13860,11750,25610,5686986
2014-02,Wyoming,2187,2231,4418,563626
2014-01,Alabama,12371,12790,25161,4779736
2014-01,Arizona,9833,7135,16968,6392017
2014-01,Arkansas,4337,5573,9910,2915918
2014-01,California,33834,27585,61419,37253956
2014-01,Colorado,14078,11498,25576,5029196
2014-01,Connecticut,5330,6693,12023,3574097
2014-01,Delaware,1325,943,2268,897934
2014-01,District of Columbia,48,3,51,601723
2014-01,Florida,37372,22370,59742,18801310
2014-01,Georgia,9861,8510,18371,9687653
2014-01,Idaho,2265,3193,5458,1567582
2014-01,Illinois,20164,11190,31354,12830632
2014-01,Indiana,14854,10418,25272,6483802
2014-01,Iowa,214,2413,2627,3046355
2014-01,Kansas,5257,5907,11164,2853118
2014-01,Kentucky,7116,6657,13773,4339367
2014-01,Louisiana,9395,10294,19689,4533372
2014-01,Maine,2476,2616,5092,1328361
2014-01,Maryland,13512,4859,18371,5773552
2014-01,Massachusetts,5374,2727,8101,6547629
2014-01,Michigan,7388,7414,14802,9883640
2014-01,Minnesota,7500,7101,14601,5303925
2014-01,Mississippi,5347,5946,11293,2967297
2014-01,Missouri,16170,12823,28993,5988927
2014-01,Montana,2280,3252,5532,989415
2014-01,Nebraska,93,1966,2059,1826341
2014-01,Nevada,3683,2761,6444,2700551
2014-01,New Hampshire,3767,2830,6597,1316470
2014-01,New Jersey,4461,3337,7798,8791894
2014-01,New Mexico,4256,3940,8196,2059179
2014-01,New York,8356,11964,20320,19378102
2014-01,North Carolina,743,11645,12388,9535483
2014-01,North Dakota,1441,2621,4062,672591
2014-01,Ohio,21851,14893,36744,11536504
2014-01,Oklahoma,11442,10339,21781,3751351
2014-01,Oregon,10184,9273,19457,3831074
2014-01,Pennsylvania,207,48368,48575,12702379
2014-01,Rhode Island,802,676,1478,1052567
2014-01,South Carolina,7312,5263,12575,4625364
2014-01,South Dakota,2283,3302,5585,814180
2014-01,Tennessee,17208,13754,30962,6346105
2014-01,Texas,39174,36808,75982,25145561
2014-01,Utah,2583,3106,5689,2763885
2014-01,Vermont,971,1067,2038,625741
2014-01,Virginia,16759,14172,30931,8001024
2014-01,Washington,13899,10505,24404,6724540
2014-01,West Virginia,5748,5726,11474,1852994
2014-01,Wisconsin,9720,8491,18211,5686986
2014-01,Wyoming,1504,1816,3320,563626
2013-12,Alabama,20186,30523,50709,4779736
2013-12,Arizona,13122,12723,25845,6392017
2013-12,Arkansas,6292,13463,19755,2915918
2013-12,California,34360,70609,104969,37253956
2013-12,Colorado,18259,20072,38331,5029196
2013-12,Connecticut,5120,4206,9326,3574097
2013-12,Delaware,1618,1871,3489,897934
2013-12,District of Columbia,32,3,35,601723
2013-12,Florida,44668,38782,83450,18801310
2013-12,Georgia,16043,22996,39039,9687653
2013-12,Idaho,3677,6904,10581,1567582
2013-12,Illinois,23671,19326,42997,12830632
2013-12,Indiana,20168,21557,41725,6483802
2013-12,Iowa,217,5671,5888,3046355
2013-12,Kansas,6785,11288,18073,2853118
2013-12,Kentucky,11500,17782,29282,4339367
2013-12,Louisiana,14000,25519,39519,4533372
2013-12,Maine,2798,4518,7316,1328361
2013-12,Maryland,10340,8061,18401,5773552
2013-12,Massachusetts,5005,3082,8087,6547629
2013-12,Michigan,9884,16140,26024,9883640
2013-12,Minnesota,8191,12738,20929,5303925
2013-12,Mississippi,8172,17156,25328,2967297
2013-12,Missouri,20002,24195,44197,5988927
2013-12,Montana,3282,6369,9651,989415
2013-12,Nebraska,157,4419,4576,1826341
2013-12,Nevada,5141,4866,10007,2700551
2013-12,New Hampshire,4472,3985,8457,1316470
2013-12,New Jersey,4332,4632,8964,8791894
2013-12,New Mexico,5833,6878,12711,2059179
2013-12,New York,8013,20786,28799,19378102
2013-12,North Carolina,1171,28667,29838,9535483
2013-12,North Dakota,1823,4293,6116,672591
2013-12,Ohio,31976,30852,62828,11536504
2013-12,Oklahoma,14536,19621,34157,3751351
2013-12,Oregon,12103,14426,26529,3831074
2013-12,Pennsylvania,20,68271,68291,12702379
2013-12,Rhode Island,846,904,1750,1052567
2013-12,South Carolina,10335,13522,23857,4625364
2013-12,South Dakota,2749,5832,8581,814180
2013-12,Tennessee,24107,29742,53849,6346105
2013-12,Texas,56566,78068,134634,25145561
2013-12,Utah,4493,7958,12451,2763885
2013-12,Vermont,1140,1629,2769,625741
2013-12,Virginia,22960,27395,50355,8001024
2013-12,Washington,17123,16363,33486,6724540
2013-12,West Virginia,9064,13497,22561,1852994
2013-12,Wisconsin,12457,14499,26956,5686986
2013-12,Wyoming,2439,3363,5802,563626
2013-11,Alabama,14646,22547,37193,4779736
2013-11,Arizona,10029,10055,20084,6392017
2013-11,Arkansas,4547,12292,16839,2915918
2013-11,California,31163,43714,74877,37253956
2013-11,Colorado,15843,16429,32272,5029196
2013-11,Connecticut,4856,3780,8636,3574097
2013-11,Delaware,1335,1809,3144,897934
2013-11,District of Columbia,29,5,34,601723
2013-11,Florida,37545,30492,68037,18801310
2013-11,Georgia,11071,16419,27490,9687653
2013-11,Idaho,2493,5285,7778,1567582
2013-11,Illinois,20356,18330,38686,12830632
2013-11,Indiana,17093,21064,38157,6483802
2013-11,Iowa,196,5246,5442,3046355
2013-11,Kansas,5534,10120,15654,2853118
2013-11,Kentucky,8074,15492,23566,4339367
2013-11,Louisiana,9894,20151,30045,4533372
2013-11,Maine,2363,5048,7411,1328361
2013-11,Maryland,7478,8311,15789,5773552
2013-11,Massachusetts,4918,3583,8501,6547629
2013-11,Michigan,8496,18252,26748,9883640
2013-11,Minnesota,7482,14683,22165,5303925
2013-11,Mississippi,5937,14525,20462,2967297
2013-11,Missouri,15610,23535,39145,5988927
2013-11,Montana,2506,5461,7967,989415
2013-11,Nebraska,100,3706,3806,1826341
2013-11,Nevada,4165,3962,8127,2700551
2013-11,New Hampshire,3898,3930,7828,1316470
2013-11,New Jersey,4849,5050,9899,8791894
2013-11,New Mexico,4612,5718,10330,2059179
2013-11,New York,7289,22304,29593,19378102
2013-11,North Carolina,858,21936,22794,9535483
2013-11,North Dakota,1499,4459,5958,672591
2013-11,Ohio,26725,29854,56579,11536504
2013-11,Oklahoma,12481,17046,29527,3751351
2013-11,Oregon,10276,12558,22834,3831074
2013-11,Pennsylvania,25,70428,70453,12702379
2013-11,Rhode Island,865,904,1769,1052567
2013-11,South Carolina,7799,10468,18267,4625364
2013-11,South Dakota,2111,5697,7808,814180
2013-11,Tennessee,19267,24267,43534,6346105
2013-11,Texas,43195,57710,100905,25145561
2013-11,Utah,3132,6023,9155,2763885
2013-11,Vermont,999,1905,2904,625741
2013-11,Virginia,19170,24822,43992,8001024
2013-11,Washington,13521,14411,27932,6724540
2013-11,West Virginia,6087,13313,19400,1852994
2013-11,Wisconsin,10913,18644,29557,5686986
2013-11,Wyoming,1802,2772,4574,563626
2013-10,Alabama,12230,15479,27709,4779736
2013-10,Arizona,8719,7750,16469,6392017
2013-10,Arkansas,3948,8699,12647,2915918
2013-10,California,30693,37814,68507,37253956
2013-10,Colorado,13346,14105,27451,5029196
2013-10,Connecticut,4324,3224,7548,3574097
2013-10,Delaware,1336,1326,2662,897934
2013-10,District of Columbia,35,1,36,601723
2013-10,Florida,34006,23276,57282,18801310
2013-10,Georgia,9429,12015,21444,9687653
2013-10,Idaho,2190,4920,7110,1567582
2013-10,Illinois,17090,14128,31218,12830632
2013-10,Indiana,14671,14624,29295,6483802
2013-10,Iowa,212,3696,3908,3046355
2013-10,Kansas,4983,7034,12017,2853118
2013-10,Kentucky,6821,10102,16923,4339367
2013-10,Louisiana,8904,15354,24258,4533372
2013-10,Maine,2664,6369,9033,1328361
2013-10,Maryland,13453,5973,19426,5773552
2013-10,Massachusetts,4844,3209,8053,6547629
2013-10,Michigan,8034,14119,22153,9883640
2013-10,Minnesota,7769,17272,25041,5303925
2013-10,Mississippi,5495,8248,13743,2967297
2013-10,Missouri,15300,18695,33995,5988927
2013-10,Montana,2378,6121,8499,989415
2013-10,Nebraska,74,2782,2856,1826341
2013-10,Nevada,3873,3221,7094,2700551
2013-10,New Hampshire,3877,3981,7858,1316470
2013-10,New Jersey,5067,4084,9151,8791894
2013-10,New Mexico,4658,4803,9461,2059179
2013-10,New York,7890,19394,27284,19378102
2013-10,North Carolina,737,15688,16425,9535483
2013-10,North Dakota,1406,5451,6857,672591
2013-10,Ohio,23348,20561,43909,11536504
2013-10,Oklahoma,9902,11757,21659,3751351
2013-10,Oregon,9127,10336,19463,3831074
2013-10,Pennsylvania,16,58745,58761,12702379
2013-10,Rhode Island,863,837,1700,1052567
2013-10,South Carolina,6311,6978,13289,4625364
2013-10,South Dakota,1873,6055,7928,814180
2013-10,Tennessee,15858,16070,31928,6346105
2013-10,Texas,36720,44769,81489,25145561
2013-10,Utah,2305,3902,6207,2763885
2013-10,Vermont,1040,1820,2860,625741
2013-10,Virginia,17306,18458,35764,8001024
2013-10,Washington,13581,12684,26265,6724540
2013-10,West Virginia,5791,9447,15238,1852994
2013-10,Wisconsin,11776,17109,28885,5686986
2013-10,Wyoming,1445,2143,3588,563626
2013-09,Alabama,11406,13077,24483,4779736
2013-09,Arizona,8488,7654,16142,6392017
2013-09,Arkansas,3773,6273,10046,2915918
2013-09,California,27422,39102,66524,37253956
2013-09,Colorado,12795,12751,25546,5029196
2013-09,Connecticut,4649,3859,8508,3574097
2013-09,Delaware,1106,1075,2181,897934
2013-09,District of Columbia,33,3,36,601723
2013-09,Florida,31866,20815,52681,18801310
2013-09,Georgia,8385,8957,17342,9687653
2013-09,Idaho,2136,4609,6745,1567582
2013-09,Illinois,14147,12860,27007,12830632
2013-09,Indiana,12956,12954,25910,6483802
2013-09,Iowa,153,3166,3319,3046355
2013-09,Kansas,4069,5993,10062,2853118
2013-09,Kentucky,6237,7751,13988,4339367
2013-09,Louisiana,10217,15969,26186,4533372
2013-09,Maine,2613,4902,7515,1328361
2013-09,Maryland,38055,9912,47967,5773552
2013-09,Massachusetts,4096,2624,6720,6547629
2013-09,Michigan,7795,13428,21223,9883640
2013-09,Minnesota,7279,16139,23418,5303925
2013-09,Mississippi,4832,6489,11321,2967297
2013-09,Missouri,14101,14257,28358,5988927
2013-09,Montana,2288,4940,7228,989415
2013-09,Nebraska,68,2256,2324,1826341
2013-09,Nevada,3358,3109,6467,2700551
2013-09,New Hampshire,3553,3355,6908,1316470
2013-09,New Jersey,4726,3189,7915,8791894
2013-09,New Mexico,3946,4090,8036,2059179
2013-09,New York,7198,16803,24001,19378102
2013-09,North Carolina,578,12550,13128,9535483
2013-09,North Dakota,1466,4170,5636,672591
2013-09,Ohio,20526,18142,38668,11536504
2013-09,Oklahoma,8639,9982,18621,3751351
2013-09,Oregon,8831,10864,19695,3831074
2013-09,Pennsylvania,16,52691,52707,12702379
2013-09,Rhode Island,759,715,1474,1052567
2013-09,South Carolina,5615,5945,11560,4625364
2013-09,South Dakota,1808,4431,6239,814180
2013-09,Tennessee,14814,13908,28722,6346105
2013-09,Texas,33690,45571,79261,25145561
2013-09,Utah,2292,3782,6074,2763885
2013-09,Vermont,1093,1553,2646,625741
2013-09,Virginia,15952,16794,32746,8001024
2013-09,Washington,11904,11700,23604,6724540
2013-09,West Virginia,5311,7849,13160,1852994
2013-09,Wisconsin,11423,14573,25996,5686986
2013-09,Wyoming,1533,2336,3869,563626
2013-08,Alabama,14310,13402,27712,4779736
2013-08,Arizona,9868,8476,18344,6392017
2013-08,Arkansas,4405,6128,10533,2915918
2013-08,California,31020,39974,70994,37253956
2013-08,Colorado,12739,12081,24820,5029196
2013-08,Connecticut,5169,3252,8421,3574097
2013-08,Delaware,1196,1032,2228,897934
2013-08,District of Columbia,32,2,34,601723
2013-08,Florida,35828,20307,56135,18801310
2013-08,Georgia,10115,8861,18976,9687653
2013-08,Idaho,2483,4221,6704,1567582
2013-08,Illinois,16360,12936,29296,12830632
2013-08,Indiana,14264,12775,27039,6483802
2013-08,Iowa,223,2519,2742,3046355
2013-08,Kansas,4823,5852,10675,2853118
2013-08,Kentucky,7225,8437,15662,4339367
2013-08,Louisiana,10247,12044,22291,4533372
2013-08,Maine,2589,3687,6276,1328361
2013-08,Maryland,7716,6779,14495,5773552
2013-08,Massachusetts,4820,3034,7854,6547629
2013-08,Michigan,7767,10728,18495,9883640
2013-08,Minnesota,7706,12119,19825,5303925
2013-08,Mississippi,6169,7080,13249,2967297
2013-08,Missouri,16625,14656,31281,5988927
2013-08,Montana,3067,4888,7955,989415
2013-08,Nebraska,92,2088,2180,1826341
2013-08,Nevada,3906,3176,7082,2700551
2013-08,New Hampshire,3823,3191,7014,1316470
2013-08,New Jersey,6036,3631,9667,8791894
2013-08,New Mexico,4583,4243,8826,2059179
2013-08,New York,7552,12961,20513,19378102
2013-08,North Carolina,1125,13357,14482,9535483
2013-08,North Dakota,1390,3155,4545,672591
2013-08,Ohio,21681,16535,38216,11536504
2013-08,Oklahoma,11047,10731,21778,3751351
2013-08,Oregon,9292,9196,18488,3831074
2013-08,Pennsylvania,29,52638,52667,12702379
2013-08,Rhode Island,827,676,1503,1052567
2013-08,South Carolina,6962,6587,13549,4625364
2013-08,South Dakota,1861,3638,5499,814180
2013-08,Tennessee,16500,14236,30736,6346105
2013-08,Texas,38576,45538,84114,25145561
2013-08,Utah,2392,3242,5634,2763885
2013-08,Vermont,984,1244,2228,625741
2013-08,Virginia,17394,14938,32332,8001024
2013-08,Washington,13247,11664,24911,6724540
2013-08,West Virginia,6037,6868,12905,1852994
2013-08,Wisconsin,10107,11966,22073,5686986
2013-08,Wyoming,1736,2241,3977,563626
2013-07,Alabama,12058,12037,24095,4779736
2013-07,Arizona,8425,6293,14718,6392017
2013-07,Arkansas,4027,4183,8210,2915918
2013-07,California,29531,31564,61095,37253956
2013-07,Colorado,11755,9266,21021,5029196
2013-07,Connecticut,4649,2497,7146,3574097
2013-07,Delaware,1183,787,1970,897934
2013-07,District of Columbia,30,1,31,601723
2013-07,Florida,34204,18664,52868,18801310
2013-07,Georgia,8893,6506,15399,9687653
2013-07,Idaho,1992,2898,4890,1567582
2013-07,Illinois,15986,10383,26369,12830632
2013-07,Indiana,12316,9385,21701,6483802
2013-07,Iowa,82,1603,1685,3046355
2013-07,Kansas,4830,4368,9198,2853118
2013-07,Kentucky,6395,6133,12528,4339367
2013-07,Louisiana,9017,8014,17031,4533372
2013-07,Maine,2244,2729,4973,1328361
2013-07,Maryland,6533,5355,11888,5773552
2013-07,Massachusetts,4283,2289,6572,6547629
2013-07,Michigan,7378,7169,14547,9883640
2013-07,Minnesota,7020,7351,14371,5303925
2013-07,Mississippi,5315,4149,9464,2967297
2013-07,Missouri,14710,10174,24884,5988927
2013-07,Montana,2393,3445,5838,989415
2013-07,Nebraska,80,1450,1530,1826341
2013-07,Nevada,3617,2706,6323,2700551
2013-07,New Hampshire,3289,2643,5932,1316470
2013-07,New Jersey,6528,3194,9722,8791894
2013-07,New Mexico,4245,3514,7759,2059179
2013-07,New York,7572,9719,17291,19378102
2013-07,North Carolina,561,9607,10168,9535483
2013-07,North Dakota,1197,2267,3464,672591
2013-07,Ohio,21099,14667,35766,11536504
2013-07,Oklahoma,10138,7996,18134,3751351
2013-07,Oregon,8386,7441,15827,3831074
2013-07,Pennsylvania,19,43118,43137,12702379
2013-07,Rhode Island,760,638,1398,1052567
2013-07,South Carolina,6074,4428,10502,4625364
2013-07,South Dakota,1675,2555,4230,814180
2013-07,Tennessee,15367,10932,26299,6346105
2013-07,Texas,35456,29941,65397,25145561
2013-07,Utah,2157,2626,4783,2763885
2013-07,Vermont,862,967,1829,625741
2013-07,Virginia,15759,12570,28329,8001024
2013-07,Washington,11752,9015,20767,6724540
2013-07,West Virginia,5348,5169,10517,1852994
2013-07,Wisconsin,8799,7823,16622,5686986
2013-07,Wyoming,1534,1694,3228,563626
2013-06,Alabama,11054,10828,21882,4779736
2013-06,Arizona,8716,6413,15129,6392017
2013-06,Arkansas,3966,3974,7940,2915918
2013-06,California,29702,35007,64709,37253956
2013-06,Colorado,16137,13206,29343,5029196
2013-06,Connecticut,4545,3693,8238,3574097
2013-06,Delaware,1175,862,2037,897934
2013-06,District of Columbia,25,1,26,601723
2013-06,Florida,33559,19343,52902,18801310
2013-06,Georgia,8591,6541,15132,9687653
2013-06,Idaho,2109,3188,5297,1567582
2013-06,Illinois,15062,10196,25258,12830632
2013-06,Indiana,12447,9845,22292,6483802
2013-06,Iowa,74,1713,1787,3046355
2013-06,Kansas,4370,4246,8616,2853118
2013-06,Kentucky,6556,5943,12499,4339367
2013-06,Louisiana,8734,7613,16347,4533372
2013-06,Maine,2427,2712,5139,1328361
2013-06,Maryland,6849,5318,12167,5773552
2013-06,Massachusetts,4109,2557,6666,6547629
2013-06,Michigan,7492,7573,15065,9883640
2013-06,Minnesota,7399,7387,14786,5303925
2013-06,Mississippi,4744,3848,8592,2967297
2013-06,Missouri,14577,10444,25021,5988927
2013-06,Montana,2433,3569,6002,989415
2013-06,Nebraska,91,1533,1624,1826341
2013-06,Nevada,4043,3125,7168,2700551
2013-06,New Hampshire,3514,2738,6252,1316470
2013-06,New Jersey,7691,3995,11686,8791894
2013-06,New Mexico,4207,3633,7840,2059179
2013-06,New York,7250,10414,17664,19378102
2013-06,North Carolina,594,9733,10327,9535483
2013-06,North Dakota,1249,2483,3732,672591
2013-06,Ohio,20896,14770,35666,11536504
2013-06,Oklahoma,9454,7955,17409,3751351
2013-06,Oregon,9161,8079,17240,3831074
2013-06,Pennsylvania,20,45518,45538,12702379
2013-06,Rhode Island,868,657,1525,1052567
2013-06,South Carolina,6228,4220,10448,4625364
2013-06,South Dakota,1761,2593,4354,814180
2013-06,Tennessee,14513,10657,25170,6346105
2013-06,Texas,34302,30708,65010,25145561
2013-06,Utah,2372,2814,5186,2763885
2013-06,Vermont,931,975,1906,625741
2013-06,Virginia,16205,12574,28779,8001024
2013-06,Washington,12717,10015,22732,6724540
2013-06,West Virginia,5304,5374,10678,1852994
2013-06,Wisconsin,8632,7553,16185,5686986
2013-06,Wyoming,1641,1840,3481,563626
2013-05,Alabama,13221,12165,25386,4779736
2013-05,Arizona,9533,7320,16853,6392017
2013-05,Arkansas,4865,4917,9782,2915918
2013-05,California,31638,37157,68795,37253956
2013-05,Colorado,15666,12799,28465,5029196
2013-05,Connecticut,4879,3459,8338,3574097
2013-05,Delaware,1476,1017,2493,897934
2013-05,District of Columbia,35,5,40,601723
2013-05,Florida,35935,21373,57308,18801310
2013-05,Georgia,9563,7116,16679,9687653
2013-05,Idaho,2470,3417,5887,1567582
2013-05,Illinois,16142,11591,27733,12830632
2013-05,Indiana,13497,10404,23901,6483802
2013-05,Iowa,78,2016,2094,3046355
2013-05,Kansas,5419,5179,10598,2853118
2013-05,Kentucky,7976,6876,14852,4339367
2013-05,Louisiana,10087,8985,19072,4533372
2013-05,Maine,2820,3092,5912,1328361
2013-05,Maryland,8507,5470,13977,5773552
2013-05,Massachusetts,4776,2714,7490,6547629
2013-05,Michigan,9056,8443,17499,9883640
2013-05,Minnesota,9637,8787,18424,5303925
2013-05,Mississippi,5369,4787,10156,2967297
2013-05,Missouri,16990,12515,29505,5988927
2013-05,Montana,2690,4067,6757,989415
2013-05,Nebraska,83,1638,1721,1826341
2013-05,Nevada,4426,3571,7997,2700551
2013-05,New Hampshire,4051,3086,7137,1316470
2013-05,New Jersey,7726,4486,12212,8791894
2013-05,New Mexico,4686,4267,8953,2059179
2013-05,New York,7992,11417,19409,19378102
2013-05,North Carolina,652,11406,12058,9535483
2013-05,North Dakota,1652,2856,4508,672591
2013-05,Ohio,23364,15596,38960,11536504
2013-05,Oklahoma,10401,9045,19446,3751351
2013-05,Oregon,10027,8727,18754,3831074
2013-05,Pennsylvania,20,49732,49752,12702379
2013-05,Rhode Island,1036,819,1855,1052567
2013-05,South Carolina,7277,4673,11950,4625364
2013-05,South Dakota,2180,3075,5255,814180
2013-05,Tennessee,16850,12546,29396,6346105
2013-05,Texas,41105,34669,75774,25145561
2013-05,Utah,2749,3255,6004,2763885
2013-05,Vermont,1030,1112,2142,625741
2013-05,Virginia,17007,13414,30421,8001024
2013-05,Washington,14262,10595,24857,6724540
2013-05,West Virginia,6371,5792,12163,1852994
2013-05,Wisconsin,11961,9200,21161,5686986
2013-05,Wyoming,2066,2174,4240,563626
2013-04,Alabama,14930,13043,27973,4779736
2013-04,Arizona,11774,8650,20424,6392017
2013-04,Arkansas,5983,6145,12128,2915918
2013-04,California,34701,42516,77217,37253956
2013-04,Colorado,18548,16004,34552,5029196
2013-04,Connecticut,6631,6531,13162,3574097
2013-04,Delaware,1871,1323,3194,897934
2013-04,District of Columbia,41,6,47,601723
2013-04,Florida,41943,25404,67347,18801310
2013-04,Georgia,11406,8593,19999,9687653
2013-04,Idaho,3115,4476,7591,1567582
2013-04,Illinois,18421,14842,33263,12830632
2013-04,Indiana,17150,14005,31155,6483802
2013-04,Iowa,120,2947,3067,3046355
2013-04,Kansas,7408,7172,14580,2853118
2013-04,Kentucky,10079,9442,19521,4339367
2013-04,Louisiana,11514,10078,21592,4533372
2013-04,Maine,3940,4331,8271,1328361
2013-04,Maryland,7924,7231,15155,5773552
2013-04,Massachusetts,5081,3717,8798,6547629
2013-04,Michigan,13166,12695,25861,9883640
2013-04,Minnesota,12801,14244,27045,5303925
2013-04,Mississippi,6469,5482,11951,2967297
2013-04,Missouri,19776,16405,36181,5988927
2013-04,Montana,3411,5035,8446,989415
2013-04,Nebraska,103,2383,2486,1826341
2013-04,Nevada,5241,4263,9504,2700551
2013-04,New Hampshire,5292,4088,9380,1316470
2013-04,New Jersey,5032,3645,8677,8791894
2013-04,New Mexico,5204,5096,10300,2059179
2013-04,New York,10237,16789,27026,19378102
2013-04,North Carolina,635,13493,14128,9535483
2013-04,North Dakota,2141,3860,6001,672591
2013-04,Ohio,31627,21579,53206,11536504
2013-04,Oklahoma,13962,11874,25836,3751351
2013-04,Oregon,12561,11056,23617,3831074
2013-04,Pennsylvania,22,64416,64438,12702379
2013-04,Rhode Island,1256,1207,2463,1052567
2013-04,South Carolina,9032,6161,15193,4625364
2013-04,South Dakota,2680,3868,6548,814180
2013-04,Tennessee,19072,14798,33870,6346105
2013-04,Texas,48822,39216,88038,25145561
2013-04,Utah,3690,4183,7873,2763885
2013-04,Vermont,1591,1883,3474,625741
2013-04,Virginia,20989,17416,38405,8001024
2013-04,Washington,17008,13057,30065,6724540
2013-04,West Virginia,7548,7408,14956,1852994
2013-04,Wisconsin,14982,15166,30148,5686986
2013-04,Wyoming,2254,2413,4667,563626
2013-03,Alabama,20215,18498,38713,4779736
2013-03,Arizona,14384,10700,25084,6392017
2013-03,Arkansas,9312,8667,17979,2915918
2013-03,California,38013,48181,86194,37253956
2013-03,Colorado,23937,20786,44723,5029196
2013-03,Connecticut,8010,8128,16138,3574097
2013-03,Delaware,2243,1755,3998,897934
2013-03,District of Columbia,48,3,51,601723
2013-03,Florida,48586,31464,80050,18801310
2013-03,Georgia,16404,12878,29282,9687653
2013-03,Idaho,4126,5603,9729,1567582
2013-03,Illinois,23779,19564,43343,12830632
2013-03,Indiana,24239,18379,42618,6483802
2013-03,Iowa,195,4400,4595,3046355
2013-03,Kansas,9708,9056,18764,2853118
2013-03,Kentucky,14921,12647,27568,4339367
2013-03,Louisiana,14463,12844,27307,4533372
2013-03,Maine,4745,4908,9653,1328361
2013-03,Maryland,8217,8190,16407,5773552
2013-03,Massachusetts,6174,4861,11035,6547629
2013-03,Michigan,17749,16343,34092,9883640
2013-03,Minnesota,15176,14763,29939,5303925
2013-03,Mississippi,8752,8146,16898,2967297
2013-03,Missouri,26501,21600,48101,5988927
2013-03,Montana,4358,5536,9894,989415
2013-03,Nebraska,134,3020,3154,1826341
2013-03,Nevada,6305,5169,11474,2700551
2013-03,New Hampshire,6519,5004,11523,1316470
2013-03,New Jersey,5369,4219,9588,8791894
2013-03,New Mexico,6870,6126,12996,2059179
2013-03,New York,12598,18458,31056,19378102
2013-03,North Carolina,936,19162,20098,9535483
2013-03,North Dakota,2735,3882,6617,672591
2013-03,Ohio,42641,27725,70366,11536504
2013-03,Oklahoma,17319,14650,31969,3751351
2013-03,Oregon,14859,13047,27906,3831074
2013-03,Pennsylvania,43,84244,84287,12702379
2013-03,Rhode Island,1546,1224,2770,1052567
2013-03,South Carolina,12620,9103,21723,4625364
2013-03,South Dakota,3537,5315,8852,814180
2013-03,Tennessee,26152,21626,47778,6346105
2013-03,Texas,64439,49206,113645,25145561
2013-03,Utah,5415,5409,10824,2763885
2013-03,Vermont,1899,2044,3943,625741
2013-03,Virginia,28321,22841,51162,8001024
2013-03,Washington,21189,15283,36472,6724540
2013-03,West Virginia,10984,10380,21364,1852994
2013-03,Wisconsin,18924,18367,37291,5686986
2013-03,Wyoming,3110,2998,6108,563626
2013-02,Alabama,24166,19763,43929,4779736
2013-02,Arizona,16313,11166,27479,6392017
2013-02,Arkansas,12200,10228,22428,2915918
2013-02,California,38087,46026,84113,37253956
2013-02,Colorado,27732,20546,48278,5029196
2013-02,Connecticut,6813,6190,13003,3574097
2013-02,Delaware,2358,1658,4016,897934
2013-02,District of Columbia,58,3,61,601723
2013-02,Florida,56967,34711,91678,18801310
2013-02,Georgia,22516,14256,36772,9687653
2013-02,Idaho,5043,5712,10755,1567582
2013-02,Illinois,24175,18387,42562,12830632
2013-02,Indiana,26643,18179,44822,6483802
2013-02,Iowa,238,3995,4233,3046355
2013-02,Kansas,11355,9238,20593,2853118
2013-02,Kentucky,19072,13980,33052,4339367
2013-02,Louisiana,16804,13560,30364,4533372
2013-02,Maine,4228,4097,8325,1328361
2013-02,Maryland,7965,7786,15751,5773552
2013-02,Massachusetts,5818,3578,9396,6547629
2013-02,Michigan,18279,14848,33127,9883640
2013-02,Minnesota,15779,12716,28495,5303925
2013-02,Mississippi,11204,9433,20637,2967297
2013-02,Missouri,30172,21984,52156,5988927
2013-02,Montana,4766,5232,9998,989415
2013-02,Nebraska,160,2993,3153,1826341
2013-02,Nevada,7432,5095,12527,2700551
2013-02,New Hampshire,6214,4434,10648,1316470
2013-02,New Jersey,4472,4274,8746,8791894
2013-02,New Mexico,7396,6328,13724,2059179
2013-02,New York,11469,17235,28704,19378102
2013-02,North Carolina,1085,21728,22813,9535483
2013-02,North Dakota,3143,3764,6907,672591
2013-02,Ohio,45622,26931,72553,11536504
2013-02,Oklahoma,20619,15693,36312,3751351
2013-02,Oregon,16691,13428,30119,3831074
2013-02,Pennsylvania,26,82258,82284,12702379
2013-02,Rhode Island,1343,992,2335,1052567
2013-02,South Carolina,16733,9776,26509,4625364
2013-02,South Dakota,4160,5054,9214,814180
2013-02,Tennessee,32630,23703,56333,6346105
2013-02,Texas,76087,52208,128295,25145561
2013-02,Utah,6512,5464,11976,2763885
2013-02,Vermont,2140,1961,4101,625741
2013-02,Virginia,32229,23554,55783,8001024
2013-02,Washington,24333,16360,40693,6724540
2013-02,West Virginia,12345,10340,22685,1852994
2013-02,Wisconsin,20921,15247,36168,5686986
2013-02,Wyoming,3284,2803,6087,563626
2013-01,Alabama,26630,22168,48798,4779736
2013-01,Arizona,19373,13109,32482,6392017
2013-01,Arkansas,11566,9868,21434,2915918
2013-01,California,51025,54527,105552,37253956
2013-01,Colorado,26419,19972,46391,5029196
2013-01,Connecticut,9275,8636,17911,3574097
2013-01,Delaware,2902,1909,4811,897934
2013-01,District of Columbia,55,4,59,601723
2013-01,Florida,68294,41844,110138,18801310
2013-01,Georgia,23439,14798,38237,9687653
2013-01,Idaho,5676,5792,11468,1567582
2013-01,Illinois,31185,22138,53323,12830632
2013-01,Indiana,30334,20505,50839,6483802
2013-01,Iowa,344,4399,4743,3046355
2013-01,Kansas,13924,10878,24802,2853118
2013-01,Kentucky,17460,13023,30483,4339367
2013-01,Louisiana,21046,17511,38557,4533372
2013-01,Maine,5306,4566,9872,1328361
2013-01,Maryland,9416,8660,18076,5773552
2013-01,Massachusetts,7295,4810,12105,6547629
2013-01,Michigan,21547,15621,37168,9883640
2013-01,Minnesota,17763,13846,31609,5303925
2013-01,Mississippi,11296,10927,22223,2967297
2013-01,Missouri,36400,24147,60547,5988927
2013-01,Montana,5509,5273,10782,989415
2013-01,Nebraska,201,3519,3720,1826341
2013-01,Nevada,8354,5865,14219,2700551
2013-01,New Hampshire,7968,6068,14036,1316470
2013-01,New Jersey,4958,5888,10846,8791894
2013-01,New Mexico,7683,6624,14307,2059179
2013-01,New York,13448,25744,39192,19378102
2013-01,North Carolina,1282,22157,23439,9535483
2013-01,North Dakota,3893,4222,8115,672591
2013-01,Ohio,49243,29034,78277,11536504
2013-01,Oklahoma,24793,17756,42549,3751351
2013-01,Oregon,19225,14044,33269,3831074
2013-01,Pennsylvania,61,93619,93680,12702379
2013-01,Rhode Island,1831,1555,3386,1052567
2013-01,South Carolina,15015,8903,23918,4625364
2013-01,South Dakota,5023,5512,10535,814180
2013-01,Tennessee,34623,23963,58586,6346105
2013-01,Texas,89130,60897,150027,25145561
2013-01,Utah,8344,5834,14178,2763885
2013-01,Vermont,2203,1810,4013,625741
2013-01,Virginia,34636,24775,59411,8001024
2013-01,Washington,28505,18241,46746,6724540
2013-01,West Virginia,12197,10377,22574,1852994
2013-01,Wisconsin,25154,15454,40608,5686986
2013-01,Wyoming,3848,2997,6845,563626
2012-12,Alabama,30614,42433,73047,4779736
2012-12,Arizona,20512,19634,40146,6392017
2012-12,Arkansas,11711,19680,31391,2915918
2012-12,California,51731,73026,124757,37253956
2012-12,Colorado,23511,24846,48357,5029196
2012-12,Connecticut,8845,9274,18119,3574097
2012-12,Delaware,2621,2747,5368,897934
2012-12,District of Columbia,50,1,51,601723
2012-12,Florida,65872,59904,125776,18801310
2012-12,Georgia,26035,32774,58809,9687653
2012-12,Idaho,6555,10015,16570,1567582
2012-12,Illinois,28548,28820,57368,12830632
2012-12,Indiana,28474,31940,60414,6483802
2012-12,Iowa,235,8121,8356,3046355
2012-12,Kansas,13854,17592,31446,2853118
2012-12,Kentucky,19442,26550,45992,4339367
2012-12,Louisiana,21599,33919,55518,4533372
2012-12,Maine,4916,6755,11671,1328361
2012-12,Maryland,7827,11046,18873,5773552
2012-12,Massachusetts,7200,5746,12946,6547629
2012-12,Michigan,7170,26867,34037,9883640
2012-12,Minnesota,13840,19260,33100,5303925
2012-12,Mississippi,12616,25190,37806,2967297
2012-12,Missouri,35516,36872,72388,5988927
2012-12,Montana,6287,8919,15206,989415
2012-12,Nebraska,224,6715,6939,1826341
2012-12,Nevada,9274,9429,18703,2700551
2012-12,New Hampshire,8412,7366,15778,1316470
2012-12,New Jersey,3825,5947,9772,8791894
2012-12,New Mexico,8477,10310,18787,2059179
2012-12,New York,9489,34876,44365,19378102
2012-12,North Carolina,1234,41758,42992,9535483
2012-12,North Dakota,3551,6324,9875,672591
2012-12,Ohio,48667,47197,95864,11536504
2012-12,Oklahoma,25216,29041,54257,3751351
2012-12,Oregon,21566,22599,44165,3831074
2012-12,Pennsylvania,78,105826,105904,12702379
2012-12,Rhode Island,1631,1865,3496,1052567
2012-12,South Carolina,16842,18436,35278,4625364
2012-12,South Dakota,5079,8910,13989,814180
2012-12,Tennessee,37951,43721,81672,6346105
2012-12,Texas,98886,108058,206944,25145561
2012-12,Utah,9885,12126,22011,2763885
2012-12,Vermont,2001,2622,4623,625741
2012-12,Virginia,36554,39104,75658,8001024
2012-12,Washington,27035,28335,55370,6724540
2012-12,West Virginia,12009,18169,30178,1852994
2012-12,Wisconsin,22343,22451,44794,5686986
2012-12,Wyoming,4157,4722,8879,563626
2012-11,Alabama,17207,27326,44533,4779736
2012-11,Arizona,12968,12975,25943,6392017
2012-11,Arkansas,6340,14554,20894,2915918
2012-11,California,35855,49929,85784,37253956
2012-11,Colorado,19733,21463,41196,5029196
2012-11,Connecticut,5819,6571,12390,3574097
2012-11,Delaware,1544,1989,3533,897934
2012-11,District of Columbia,37,3,40,601723
2012-11,Florida,43550,37856,81406,18801310
2012-11,Georgia,13482,19167,32649,9687653
2012-11,Idaho,3360,6640,10000,1567582
2012-11,Illinois,16845,22364,39209,12830632
2012-11,Indiana,17383,24331,41714,6483802
2012-11,Iowa,157,7217,7374,3046355
2012-11,Kansas,8330,12794,21124,2853118
2012-11,Kentucky,10571,17789,28360,4339367
2012-11,Louisiana,11882,22676,34558,4533372
2012-11,Maine,3024,5425,8449,1328361
2012-11,Maryland,7141,9488,16629,5773552
2012-11,Massachusetts,4870,4149,9019,6547629
2012-11,Michigan,1453,22403,23856,9883640
2012-11,Minnesota,8820,15392,24212,5303925
2012-11,Mississippi,6880,18507,25387,2967297
2012-11,Missouri,19943,27029,46972,5988927
2012-11,Montana,3127,5926,9053,989415
2012-11,Nebraska,128,5162,5290,1826341
2012-11,Nevada,5795,5961,11756,2700551
2012-11,New Hampshire,4740,4934,9674,1316470
2012-11,New Jersey,3647,5013,8660,8791894
2012-11,New Mexico,5038,6492,11530,2059179
2012-11,New York,6692,28126,34818,19378102
2012-11,North Carolina,798,27342,28140,9535483
2012-11,North Dakota,1704,4810,6514,672591
2012-11,Ohio,32230,36389,68619,11536504
2012-11,Oklahoma,16850,20102,36952,3751351
2012-11,Oregon,12059,15041,27100,3831074
2012-11,Pennsylvania,50,78231,78281,12702379
2012-11,Rhode Island,1028,1224,2252,1052567
2012-11,South Carolina,10098,12015,22113,4625364
2012-11,South Dakota,2663,6767,9430,814180
2012-11,Tennessee,22221,28279,50500,6346105
2012-11,Texas,52840,64903,117743,25145561
2012-11,Utah,4720,7559,12279,2763885
2012-11,Vermont,1096,1994,3090,625741
2012-11,Virginia,22826,28382,51208,8001024
2012-11,Washington,17319,18004,35323,6724540
2012-11,West Virginia,6753,14321,21074,1852994
2012-11,Wisconsin,14976,20715,35691,5686986
2012-11,Wyoming,2360,3136,5496,563626
2012-10,Alabama,12104,14698,26802,4779736
2012-10,Arizona,9272,7918,17190,6392017
2012-10,Arkansas,4520,9560,14080,2915918
2012-10,California,28860,30305,59165,37253956
2012-10,Colorado,14356,15055,29411,5029196
2012-10,Connecticut,4725,4865,9590,3574097
2012-10,Delaware,1171,1235,2406,897934
2012-10,District of Columbia,50,3,53,601723
2012-10,Florida,35686,23640,59326,18801310
2012-10,Georgia,9597,12258,21855,9687653
2012-10,Idaho,2226,5153,7379,1567582
2012-10,Illinois,13118,15029,28147,12830632
2012-10,Indiana,14083,15844,29927,6483802
2012-10,Iowa,128,4538,4666,3046355
2012-10,Kansas,5721,7612,13333,2853118
2012-10,Kentucky,8226,11474,19700,4339367
2012-10,Louisiana,9056,16181,25237,4533372
2012-10,Maine,2684,6431,9115,1328361
2012-10,Maryland,5491,5835,11326,5773552
2012-10,Massachusetts,4609,3111,7720,6547629
2012-10,Michigan,1313,15585,16898,9883640
2012-10,Minnesota,7752,20598,28350,5303925
2012-10,Mississippi,4859,10027,14886,2967297
2012-10,Missouri,15628,20116,35744,5988927
2012-10,Montana,2662,6824,9486,989415
2012-10,Nebraska,88,3579,3667,1826341
2012-10,Nevada,4404,3703,8107,2700551
2012-10,New Hampshire,3740,4058,7798,1316470
2012-10,New Jersey,3393,3228,6621,8791894
2012-10,New Mexico,4238,4644,8882,2059179
2012-10,New York,6546,21226,27772,19378102
2012-10,North Carolina,788,16214,17002,9535483
2012-10,North Dakota,1559,6165,7724,672591
2012-10,Ohio,23729,21397,45126,11536504
2012-10,Oklahoma,10986,12235,23221,3751351
2012-10,Oregon,9513,10440,19953,3831074
2012-10,Pennsylvania,29,58116,58145,12702379
2012-10,Rhode Island,879,853,1732,1052567
2012-10,South Carolina,7498,7606,15104,4625364
2012-10,South Dakota,2144,7113,9257,814180
2012-10,Tennessee,16835,16902,33737,6346105
2012-10,Texas,37556,44643,82199,25145561
2012-10,Utah,2418,4257,6675,2763885
2012-10,Vermont,1061,2033,3094,625741
2012-10,Virginia,16759,17809,34568,8001024
2012-10,Washington,13645,13258,26903,6724540
2012-10,West Virginia,5692,9496,15188,1852994
2012-10,Wisconsin,12674,18015,30689,5686986
2012-10,Wyoming,1550,2439,3989,563626
2012-09,Alabama,10831,12511,23342,4779736
2012-09,Arizona,9685,7771,17456,6392017
2012-09,Arkansas,4717,7672,12389,2915918
2012-09,California,26752,29344,56096,37253956
2012-09,Colorado,13865,13590,27455,5029196
2012-09,Connecticut,4440,4025,8465,3574097
2012-09,Delaware,1097,973,2070,897934
2012-09,District of Columbia,28,1,29,601723
2012-09,Florida,33996,20479,54475,18801310
2012-09,Georgia,9188,9206,18394,9687653
2012-09,Idaho,2439,4728,7167,1567582
2012-09,Illinois,11788,12727,24515,12830632
2012-09,Indiana,12916,12873,25789,6483802
2012-09,Iowa,81,3379,3460,3046355
2012-09,Kansas,5147,6172,11319,2853118
2012-09,Kentucky,7850,9397,17247,4339367
2012-09,Louisiana,11017,16304,27321,4533372
2012-09,Maine,2838,5155,7993,1328361
2012-09,Maryland,4569,4704,9273,5773552
2012-09,Massachusetts,4108,2536,6644,6547629
2012-09,Michigan,1039,14424,15463,9883640
2012-09,Minnesota,7119,16723,23842,5303925
2012-09,Mississippi,4532,7018,11550,2967297
2012-09,Missouri,15282,15154,30436,5988927
2012-09,Montana,2673,5512,8185,989415
2012-09,Nebraska,80,2506,2586,1826341
2012-09,Nevada,4325,3638,7963,2700551
2012-09,New Hampshire,3837,3776,7613,1316470
2012-09,New Jersey,3487,2801,6288,8791894
2012-09,New Mexico,4034,4265,8299,2059179
2012-09,New York,5784,19289,25073,19378102
2012-09,North Carolina,662,13039,13701,9535483
2012-09,North Dakota,1435,4176,5611,672591
2012-09,Ohio,22700,18049,40749,11536504
2012-09,Oklahoma,10048,10635,20683,3751351
2012-09,Oregon,9240,10918,20158,3831074
2012-09,Pennsylvania,27,53559,53586,12702379
2012-09,Rhode Island,821,791,1612,1052567
2012-09,South Carolina,6784,6071,12855,4625364
2012-09,South Dakota,2033,4472,6505,814180
2012-09,Tennessee,15153,14344,29497,6346105
2012-09,Texas,36471,45464,81935,25145561
2012-09,Utah,2559,3815,6374,2763885
2012-09,Vermont,1128,1774,2902,625741
2012-09,Virginia,17365,15658,33023,8001024
2012-09,Washington,12209,11217,23426,6724540
2012-09,West Virginia,5746,8041,13787,1852994
2012-09,Wisconsin,11137,14610,25747,5686986
2012-09,Wyoming,1599,2408,4007,563626
2012-08,Alabama,13805,12264,26069,4779736
2012-08,Arizona,10858,8157,19015,6392017
2012-08,Arkansas,4935,6330,11265,2915918
2012-08,California,29494,31911,61405,37253956
2012-08,Colorado,15970,13345,29315,5029196
2012-08,Connecticut,4776,3816,8592,3574097
2012-08,Delaware,1198,980,2178,897934
2012-08,District of Columbia,37,3,40,601723
2012-08,Florida,37184,20301,57485,18801310
2012-08,Georgia,10610,9326,19936,9687653
2012-08,Idaho,2571,4123,6694,1567582
2012-08,Illinois,12980,14054,27034,12830632
2012-08,Indiana,13991,12638,26629,6483802
2012-08,Iowa,82,2810,2892,3046355
2012-08,Kansas,5923,6423,12346,2853118
2012-08,Kentucky,8244,8463,16707,4339367
2012-08,Louisiana,9985,11956,21941,4533372
2012-08,Maine,2833,3623,6456,1328361
2012-08,Maryland,5534,4683,10217,5773552
2012-08,Massachusetts,4616,2689,7305,6547629
2012-08,Michigan,1179,11769,12948,9883640
2012-08,Minnesota,7738,12588,20326,5303925
2012-08,Mississippi,5764,7545,13309,2967297
2012-08,Missouri,16799,15229,32028,5988927
2012-08,Montana,3047,4567,7614,989415
2012-08,Nebraska,91,2335,2426,1826341
2012-08,Nevada,4693,3576,8269,2700551
2012-08,New Hampshire,3890,3151,7041,1316470
2012-08,New Jersey,3918,3039,6957,8791894
2012-08,New Mexico,4661,4097,8758,2059179
2012-08,New York,6177,14572,20749,19378102
2012-08,North Carolina,663,13545,14208,9535483
2012-08,North Dakota,1532,3269,4801,672591
2012-08,Ohio,23175,16601,39776,11536504
2012-08,Oklahoma,12054,10903,22957,3751351
2012-08,Oregon,9485,8795,18280,3831074
2012-08,Pennsylvania,44,72106,72150,12702379
2012-08,Rhode Island,771,744,1515,1052567
2012-08,South Carolina,7592,6331,13923,4625364
2012-08,South Dakota,2131,3794,5925,814180
2012-08,Tennessee,17328,15654,32982,6346105
2012-08,Texas,40131,44238,84369,25145561
2012-08,Utah,2746,3221,5967,2763885
2012-08,Vermont,1073,1258,2331,625741
2012-08,Virginia,17146,14148,31294,8001024
2012-08,Washington,13652,10437,24089,6724540
2012-08,West Virginia,6099,6846,12945,1852994
2012-08,Wisconsin,11551,11991,23542,5686986
2012-08,Wyoming,1813,2131,3944,563626
2012-07,Alabama,12182,9921,22103,4779736
2012-07,Arizona,9696,6340,16036,6392017
2012-07,Arkansas,4346,4738,9084,2915918
2012-07,California,26313,27530,53843,37253956
2012-07,Colorado,13433,10672,24105,5029196
2012-07,Connecticut,4099,2942,7041,3574097
2012-07,Delaware,1031,802,1833,897934
2012-07,District of Columbia,41,0,41,601723
2012-07,Florida,34543,17864,52407,18801310
2012-07,Georgia,9216,6776,15992,9687653
2012-07,Idaho,2052,2972,5024,1567582
2012-07,Illinois,11401,9755,21156,12830632
2012-07,Indiana,11809,9380,21189,6483802
2012-07,Iowa,73,2036,2109,3046355
2012-07,Kansas,5192,4622,9814,2853118
2012-07,Kentucky,7523,6566,14089,4339367
2012-07,Louisiana,8963,8184,17147,4533372
2012-07,Maine,2231,2681,4912,1328361
2012-07,Maryland,4558,3668,8226,5773552
2012-07,Massachusetts,3734,1973,5707,6547629
2012-07,Michigan,1026,8053,9079,9883640
2012-07,Minnesota,6424,7588,14012,5303925
2012-07,Mississippi,4557,4712,9269,2967297
2012-07,Missouri,13903,10796,24699,5988927
2012-07,Montana,2532,3400,5932,989415
2012-07,Nebraska,73,1595,1668,1826341
2012-07,Nevada,4086,3108,7194,2700551
2012-07,New Hampshire,3350,2598,5948,1316470
2012-07,New Jersey,3759,2504,6263,8791894
2012-07,New Mexico,3853,3378,7231,2059179
2012-07,New York,6002,11448,17450,19378102
2012-07,North Carolina,653,9311,9964,9535483
2012-07,North Dakota,1273,2344,3617,672591
2012-07,Ohio,20677,13904,34581,11536504
2012-07,Oklahoma,10487,7960,18447,3751351
2012-07,Oregon,8707,7660,16367,3831074
2012-07,Pennsylvania,40,63868,63908,12702379
2012-07,Rhode Island,763,622,1385,1052567
2012-07,South Carolina,6315,4318,10633,4625364
2012-07,South Dakota,1693,2627,4320,814180
2012-07,Tennessee,15308,11123,26431,6346105
2012-07,Texas,35783,29918,65701,25145561
2012-07,Utah,2227,2623,4850,2763885
2012-07,Vermont,985,1019,2004,625741
2012-07,Virginia,17361,12028,29389,8001024
2012-07,Washington,12532,9007,21539,6724540
2012-07,West Virginia,4976,4724,9700,1852994
2012-07,Wisconsin,10575,7702,18277,5686986
2012-07,Wyoming,1413,1653,3066,563626
2012-06,Alabama,11540,9390,20930,4779736
2012-06,Arizona,8893,6121,15014,6392017
2012-06,Arkansas,4158,4241,8399,2915918
2012-06,California,26514,27427,53941,37253956
2012-06,Colorado,11986,10435,22421,5029196
2012-06,Connecticut,4452,3178,7630,3574097
2012-06,Delaware,925,748,1673,897934
2012-06,District of Columbia,18,2,20,601723
2012-06,Florida,33679,17828,51507,18801310
2012-06,Georgia,9085,6591,15676,9687653
2012-06,Idaho,2280,3426,5706,1567582
2012-06,Illinois,11820,10114,21934,12830632
2012-06,Indiana,12193,9656,21849,6483802
2012-06,Iowa,72,2177,2249,3046355
2012-06,Kansas,4655,4532,9187,2853118
2012-06,Kentucky,7304,6699,14003,4339367
2012-06,Louisiana,8801,7345,16146,4533372
2012-06,Maine,2420,2710,5130,1328361
2012-06,Maryland,4118,3729,7847,5773552
2012-06,Massachusetts,3896,2244,6140,6547629
2012-06,Michigan,1083,7942,9025,9883640
2012-06,Minnesota,6576,7472,14048,5303925
2012-06,Mississippi,4542,4153,8695,2967297
2012-06,Missouri,14002,10593,24595,5988927
2012-06,Montana,2878,3956,6834,989415
2012-06,Nebraska,70,1749,1819,1826341
2012-06,Nevada,4141,3310,7451,2700551
2012-06,New Hampshire,3132,2691,5823,1316470
2012-06,New Jersey,4070,2484,6554,8791894
2012-06,New Mexico,4166,3562,7728,2059179
2012-06,New York,5894,11424,17318,19378102
2012-06,North Carolina,650,9506,10156,9535483
2012-06,North Dakota,1328,2498,3826,672591
2012-06,Ohio,20125,14019,34144,11536504
2012-06,Oklahoma,10167,7651,17818,3751351
2012-06,Oregon,9096,8210,17306,3831074
2012-06,Pennsylvania,53,60185,60238,12702379
2012-06,Rhode Island,740,601,1341,1052567
2012-06,South Carolina,6625,4286,10911,4625364
2012-06,South Dakota,1599,2530,4129,814180
2012-06,Tennessee,14810,10732,25542,6346105
2012-06,Texas,34768,28889,63657,25145561
2012-06,Utah,2411,2967,5378,2763885
2012-06,Vermont,1005,975,1980,625741
2012-06,Virginia,14451,10979,25430,8001024
2012-06,Washington,13288,10506,23794,6724540
2012-06,West Virginia,4691,4743,9434,1852994
2012-06,Wisconsin,9771,7465,17236,5686986
2012-06,Wyoming,1612,1739,3351,563626
2012-05,Alabama,11097,8917,20014,4779736
2012-05,Arizona,9374,6136,15510,6392017
2012-05,Arkansas,4128,4107,8235,2915918
2012-05,California,27699,27093,54792,37253956
2012-05,Colorado,12175,10380,22555,5029196
2012-05,Connecticut,4529,3187,7716,3574097
2012-05,Delaware,1020,733,1753,897934
2012-05,District of Columbia,26,0,26,601723
2012-05,Florida,33310,17547,50857,18801310
2012-05,Georgia,8851,6254,15105,9687653
2012-05,Idaho,2322,3293,5615,1567582
2012-05,Illinois,11987,9817,21804,12830632
2012-05,Indiana,11816,9152,20968,6483802
2012-05,Iowa,72,1916,1988,3046355
2012-05,Kansas,4819,4442,9261,2853118
2012-05,Kentucky,6851,6038,12889,4339367
2012-05,Louisiana,7898,6675,14573,4533372
2012-05,Maine,2574,2766,5340,1328361
2012-05,Maryland,5249,3609,8858,5773552
2012-05,Massachusetts,4023,2152,6175,6547629
2012-05,Michigan,1137,8249,9386,9883640
2012-05,Minnesota,7335,7792,15127,5303925
2012-05,Mississippi,4740,3882,8622,2967297
2012-05,Missouri,13959,10395,24354,5988927
2012-05,Montana,2763,3990,6753,989415
2012-05,Nebraska,85,1610,1695,1826341
2012-05,Nevada,4576,3268,7844,2700551
2012-05,New Hampshire,3518,2797,6315,1316470
2012-05,New Jersey,4263,2498,6761,8791894
2012-05,New Mexico,4058,3474,7532,2059179
2012-05,New York,6541,12175,18716,19378102
2012-05,North Carolina,625,9359,9984,9535483
2012-05,North Dakota,1512,2547,4059,672591
2012-05,Ohio,20446,13211,33657,11536504
2012-05,Oklahoma,10357,7173,17530,3751351
2012-05,Oregon,8652,8245,16897,3831074
2012-05,Pennsylvania,36,62046,62082,12702379
2012-05,Rhode Island,841,680,1521,1052567
2012-05,South Carolina,7126,3983,11109,4625364
2012-05,South Dakota,1819,2508,4327,814180
2012-05,Tennessee,14337,9980,24317,6346105
2012-05,Texas,34541,28197,62738,25145561
2012-05,Utah,2430,2967,5397,2763885
2012-05,Vermont,995,1122,2117,625741
2012-05,Virginia,14213,10795,25008,8001024
2012-05,Washington,13651,9650,23301,6724540
2012-05,West Virginia,5025,4748,9773,1852994
2012-05,Wisconsin,10997,8077,19074,5686986
2012-05,Wyoming,1780,1830,3610,563626
2012-04,Alabama,11518,9586,21104,4779736
2012-04,Arizona,10656,6984,17640,6392017
2012-04,Arkansas,4299,4209,8508,2915918
2012-04,California,29500,30211,59711,37253956
2012-04,Colorado,12909,11210,24119,5029196
2012-04,Connecticut,4895,3659,8554,3574097
2012-04,Delaware,1096,839,1935,897934
2012-04,District of Columbia,27,1,28,601723
2012-04,Florida,34847,18257,53104,18801310
2012-04,Georgia,9481,6670,16151,9687653
2012-04,Idaho,2509,3720,6229,1567582
2012-04,Illinois,14524,11497,26021,12830632
2012-04,Indiana,13520,10411,23931,6483802
2012-04,Iowa,116,2712,2828,3046355
2012-04,Kansas,5453,4948,10401,2853118
2012-04,Kentucky,7521,7238,14759,4339367
2012-04,Louisiana,8397,6858,15255,4533372
2012-04,Maine,3191,3070,6261,1328361
2012-04,Maryland,5555,4361,9916,5773552
2012-04,Massachusetts,4231,2670,6901,6547629
2012-04,Michigan,1314,10018,11332,9883640
2012-04,Minnesota,9004,10769,19773,5303925
2012-04,Mississippi,4656,4067,8723,2967297
2012-04,Missouri,15210,12050,27260,5988927
2012-04,Montana,3097,4180,7277,989415
2012-04,Nebraska,72,1934,2006,1826341
2012-04,Nevada,4683,3846,8529,2700551
2012-04,New Hampshire,4066,3128,7194,1316470
2012-04,New Jersey,4047,2685,6732,8791894
2012-04,New Mexico,4246,3779,8025,2059179
2012-04,New York,6768,15285,22053,19378102
2012-04,North Carolina,595,10061,10656,9535483
2012-04,North Dakota,1956,3032,4988,672591
2012-04,Ohio,25352,15717,41069,11536504
2012-04,Oklahoma,10982,8339,19321,3751351
2012-04,Oregon,10426,9978,20404,3831074
2012-04,Pennsylvania,29,71424,71453,12702379
2012-04,Rhode Island,953,720,1673,1052567
2012-04,South Carolina,7911,4404,12315,4625364
2012-04,South Dakota,2122,2937,5059,814180
2012-04,Tennessee,15736,10927,26663,6346105
2012-04,Texas,36296,28840,65136,25145561
2012-04,Utah,2968,3317,6285,2763885
2012-04,Vermont,1321,1468,2789,625741
2012-04,Virginia,17649,12196,29845,8001024
2012-04,Washington,14790,11022,25812,6724540
2012-04,West Virginia,5629,5942,11571,1852994
2012-04,Wisconsin,14046,11444,25490,5686986
2012-04,Wyoming,1786,1974,3760,563626
2012-03,Alabama,15995,12285,28280,4779736
2012-03,Arizona,13484,9115,22599,6392017
2012-03,Arkansas,6928,6170,13098,2915918
2012-03,California,36137,38797,74934,37253956
2012-03,Colorado,16271,14039,30310,5029196
2012-03,Connecticut,6139,4498,10637,3574097
2012-03,Delaware,1350,1057,2407,897934
2012-03,District of Columbia,34,0,34,601723
2012-03,Florida,41823,21504,63327,18801310
2012-03,Georgia,14631,9607,24238,9687653
2012-03,Idaho,3474,5160,8634,1567582
2012-03,Illinois,17725,14376,32101,12830632
2012-03,Indiana,18763,13250,32013,6483802
2012-03,Iowa,162,3926,4088,3046355
2012-03,Kansas,8582,7394,15976,2853118
2012-03,Kentucky,11306,9638,20944,4339367
2012-03,Louisiana,11125,8996,20121,4533372
2012-03,Maine,4007,3768,7775,1328361
2012-03,Maryland,6244,5099,11343,5773552
2012-03,Massachusetts,5410,3128,8538,6547629
2012-03,Michigan,1575,12952,14527,9883640
2012-03,Minnesota,10954,12722,23676,5303925
2012-03,Mississippi,6661,5848,12509,2967297
2012-03,Missouri,20609,15430,36039,5988927
2012-03,Montana,3784,4832,8616,989415
2012-03,Nebraska,124,2542,2666,1826341
2012-03,Nevada,5913,4642,10555,2700551
2012-03,New Hampshire,4593,3402,7995,1316470
2012-03,New Jersey,4266,3154,7420,8791894
2012-03,New Mexico,5722,5160,10882,2059179
2012-03,New York,8068,17056,25124,19378102
2012-03,North Carolina,746,12962,13708,9535483
2012-03,North Dakota,2657,3621,6278,672591
2012-03,Ohio,33749,19245,52994,11536504
2012-03,Oklahoma,14529,10953,25482,3751351
2012-03,Oregon,12906,12430,25336,3831074
2012-03,Pennsylvania,64,92661,92725,12702379
2012-03,Rhode Island,1167,934,2101,1052567
2012-03,South Carolina,11548,6054,17602,4625364
2012-03,South Dakota,2847,3863,6710,814180
2012-03,Tennessee,19732,14661,34393,6346105
2012-03,Texas,47874,37409,85283,25145561
2012-03,Utah,4131,4265,8396,2763885
2012-03,Vermont,1679,1776,3455,625741
2012-03,Virginia,21304,14545,35849,8001024
2012-03,Washington,17010,12812,29822,6724540
2012-03,West Virginia,7815,7501,15316,1852994
2012-03,Wisconsin,17351,14968,32319,5686986
2012-03,Wyoming,2352,2485,4837,563626
2012-02,Alabama,18348,13565,31913,4779736
2012-02,Arizona,14082,8959,23041,6392017
2012-02,Arkansas,8513,7724,16237,2915918
2012-02,California,30902,31877,62779,37253956
2012-02,Colorado,17069,14133,31202,5029196
2012-02,Connecticut,5957,4073,10030,3574097
2012-02,Delaware,1463,950,2413,897934
2012-02,District of Columbia,36,2,38,601723
2012-02,Florida,43744,22852,66596,18801310
2012-02,Georgia,18514,11296,29810,9687653
2012-02,Idaho,3273,4340,7613,1567582
2012-02,Illinois,17750,14271,32021,12830632
2012-02,Indiana,19808,14257,34065,6483802
2012-02,Iowa,153,3884,4037,3046355
2012-02,Kansas,8293,7353,15646,2853118
2012-02,Kentucky,14498,11882,26380,4339367
2012-02,Louisiana,12534,9441,21975,4533372
2012-02,Maine,3446,3473,6919,1328361
2012-02,Maryland,6192,5519,11711,5773552
2012-02,Massachusetts,4431,2478,6909,6547629
2012-02,Michigan,1492,12631,14123,9883640
2012-02,Minnesota,9320,9761,19081,5303925
2012-02,Mississippi,8447,7201,15648,2967297
2012-02,Missouri,23012,16630,39642,5988927
2012-02,Montana,3705,4128,7833,989415
2012-02,Nebraska,96,2418,2514,1826341
2012-02,Nevada,5623,3881,9504,2700551
2012-02,New Hampshire,4297,3128,7425,1316470
2012-02,New Jersey,3556,2862,6418,8791894
2012-02,New Mexico,5702,4863,10565,2059179
2012-02,New York,8269,17120,25389,19378102
2012-02,North Carolina,857,16115,16972,9535483
2012-02,North Dakota,2569,3031,5600,672591
2012-02,Ohio,35526,19840,55366,11536504
2012-02,Oklahoma,15562,11793,27355,3751351
2012-02,Oregon,12089,11200,23289,3831074
2012-02,Pennsylvania,67,89116,89183,12702379
2012-02,Rhode Island,1142,793,1935,1052567
2012-02,South Carolina,15798,7433,23231,4625364
2012-02,South Dakota,2818,3739,6557,814180
2012-02,Tennessee,25658,17153,42811,6346105
2012-02,Texas,54703,40563,95266,25145561
2012-02,Utah,3561,3811,7372,2763885
2012-02,Vermont,1602,1501,3103,625741
2012-02,Virginia,24439,15704,40143,8001024
2012-02,Washington,16266,11830,28096,6724540
2012-02,West Virginia,8774,8171,16945,1852994
2012-02,Wisconsin,18262,11969,30231,5686986
2012-02,Wyoming,2094,2124,4218,563626
2012-01,Alabama,11998,11176,23174,4779736
2012-01,Arizona,9570,6969,16539,6392017
2012-01,Arkansas,4886,5554,10440,2915918
2012-01,California,25812,25757,51569,37253956
2012-01,Colorado,13711,11801,25512,5029196
2012-01,Connecticut,4894,3904,8798,3574097
2012-01,Delaware,1168,820,1988,897934
2012-01,District of Columbia,43,2,45,601723
2012-01,Florida,34951,18761,53712,18801310
2012-01,Georgia,10796,8258,19054,9687653
2012-01,Idaho,2368,3491,5859,1567582
2012-01,Illinois,13424,11581,25005,12830632
2012-01,Indiana,14224,10574,24798,6483802
2012-01,Iowa,142,3006,3148,3046355
2012-01,Kansas,6316,6557,12873,2853118
2012-01,Kentucky,8633,7855,16488,4339367
2012-01,Louisiana,8549,9237,17786,4533372
2012-01,Maine,2438,2777,5215,1328361
2012-01,Maryland,4431,4196,8627,5773552
2012-01,Massachusetts,4008,2157,6165,6547629
2012-01,Michigan,1224,8653,9877,9883640
2012-01,Minnesota,7238,7956,15194,5303925
2012-01,Mississippi,4703,6212,10915,2967297
2012-01,Missouri,15948,12991,28939,5988927
2012-01,Montana,2684,3218,5902,989415
2012-01,Nebraska,75,2613,2688,1826341
2012-01,Nevada,4416,3282,7698,2700551
2012-01,New Hampshire,3406,2573,5979,1316470
2012-01,New Jersey,2920,2293,5213,8791894
2012-01,New Mexico,3960,3531,7491,2059179
2012-01,New York,6654,11877,18531,19378102
2012-01,North Carolina,564,11920,12484,9535483
2012-01,North Dakota,1862,2709,4571,672591
2012-01,Ohio,22307,13742,36049,11536504
2012-01,Oklahoma,11440,9760,21200,3751351
2012-01,Oregon,8921,8346,17267,3831074
2012-01,Pennsylvania,19,66405,66424,12702379
2012-01,Rhode Island,868,681,1549,1052567
2012-01,South Carolina,8972,5218,14190,4625364
2012-01,South Dakota,2000,3541,5541,814180
2012-01,Tennessee,18029,12590,30619,6346105
2012-01,Texas,38234,34319,72553,25145561
2012-01,Utah,2681,3052,5733,2763885
2012-01,Vermont,945,1048,1993,625741
2012-01,Virginia,15822,11720,27542,8001024
2012-01,Washington,12273,8772,21045,6724540
2012-01,West Virginia,5384,6047,11431,1852994
2012-01,Wisconsin,12254,8655,20909,5686986
2012-01,Wyoming,1513,1622,3135,563626
2011-12,Alabama,17651,28564,46215,4779736
2011-12,Arizona,12018,11689,23707,6392017
2011-12,Arkansas,6900,13747,20647,2915918
2011-12,California,29452,36425,65877,37253956
2011-12,Colorado,16990,19525,36515,5029196
2011-12,Connecticut,5210,5383,10593,3574097
2011-12,Delaware,1430,1760,3190,897934
2011-12,District of Columbia,19,2,21,601723
2011-12,Florida,40463,31791,72254,18801310
2011-12,Georgia,15777,22801,38578,9687653
2011-12,Idaho,3584,6887,10471,1567582
2011-12,Illinois,15946,18596,34542,12830632
2011-12,Indiana,16616,19842,36458,6483802
2011-12,Iowa,145,6670,6815,3046355
2011-12,Kansas,7204,11848,19052,2853118
2011-12,Kentucky,12400,19464,31864,4339367
2011-12,Louisiana,12503,24866,37369,4533372
2011-12,Maine,3061,5123,8184,1328361
2011-12,Maryland,4522,7805,12327,5773552
2011-12,Massachusetts,4399,2948,7347,6547629
2011-12,Michigan,1394,17339,18733,9883640
2011-12,Minnesota,8269,13584,21853,5303925
2011-12,Mississippi,7880,19013,26893,2967297
2011-12,Missouri,19205,23887,43092,5988927
2011-12,Montana,3475,6151,9626,989415
2011-12,Nebraska,135,5431,5566,1826341
2011-12,Nevada,5671,5643,11314,2700551
2011-12,New Hampshire,3771,3915,7686,1316470
2011-12,New Jersey,2928,3883,6811,8791894
2011-12,New Mexico,5083,6281,11364,2059179
2011-12,New York,6497,21271,27768,19378102
2011-12,North Carolina,653,27849,28502,9535483
2011-12,North Dakota,1811,4256,6067,672591
2011-12,Ohio,29717,28886,58603,11536504
2011-12,Oklahoma,13809,18920,32729,3751351
2011-12,Oregon,10490,13794,24284,3831074
2011-12,Pennsylvania,32,83662,83694,12702379
2011-12,Rhode Island,921,896,1817,1052567
2011-12,South Carolina,11221,13522,24743,4625364
2011-12,South Dakota,2346,5734,8080,814180
2011-12,Tennessee,24452,27923,52375,6346105
2011-12,Texas,55187,73202,128389,25145561
2011-12,Utah,4498,8103,12601,2763885
2011-12,Vermont,1198,1819,3017,625741
2011-12,Virginia,19470,23046,42516,8001024
2011-12,Washington,16005,15941,31946,6724540
2011-12,West Virginia,8082,13332,21414,1852994
2011-12,Wisconsin,15127,13551,28678,5686986
2011-12,Wyoming,2350,3227,5577,563626
2011-11,Alabama,11548,20228,31776,4779736
2011-11,Arizona,8315,8157,16472,6392017
2011-11,Arkansas,4022,12035,16057,2915918
2011-11,California,23885,30091,53976,37253956
2011-11,Colorado,12727,15131,27858,5029196
2011-11,Connecticut,3855,4084,7939,3574097
2011-11,Delaware,971,1402,2373,897934
2011-11,District of Columbia,33,0,33,601723
2011-11,Florida,30827,23480,54307,18801310
2011-11,Georgia,8691,14424,23115,9687653
2011-11,Idaho,2269,4537,6806,1567582
2011-11,Illinois,12039,16397,28436,12830632
2011-11,Indiana,11350,17074,28424,6483802
2011-11,Iowa,134,6094,6228,3046355
2011-11,Kansas,5262,10033,15295,2853118
2011-11,Kentucky,7447,15122,22569,4339367
2011-11,Louisiana,8077,17355,25432,4533372
2011-11,Maine,2087,4270,6357,1328361
2011-11,Maryland,3760,7540,11300,5773552
2011-11,Massachusetts,3475,2605,6080,6547629
2011-11,Michigan,1005,18342,19347,9883640
2011-11,Minnesota,5749,12848,18597,5303925
2011-11,Mississippi,4776,14867,19643,2967297
2011-11,Missouri,12697,20547,33244,5988927
2011-11,Montana,2134,4327,6461,989415
2011-11,Nebraska,82,4494,4576,1826341
2011-11,Nevada,4176,4092,8268,2700551
2011-11,New Hampshire,2783,3236,6019,1316470
2011-11,New Jersey,2504,3291,5795,8791894
2011-11,New Mexico,3737,4418,8155,2059179
2011-11,New York,5030,20098,25128,19378102
2011-11,North Carolina,299,19954,20253,9535483
2011-11,North Dakota,1332,3914,5246,672591
2011-11,Ohio,21362,24640,46002,11536504
2011-11,Oklahoma,9810,14561,24371,3751351
2011-11,Oregon,7772,9906,17678,3831074
2011-11,Pennsylvania,24,73464,73488,12702379
2011-11,Rhode Island,713,712,1425,1052567
2011-11,South Carolina,7743,9294,17037,4625364
2011-11,South Dakota,1556,5038,6594,814180
2011-11,Tennessee,16350,21019,37369,6346105
2011-11,Texas,35928,49253,85181,25145561
2011-11,Utah,3021,5120,8141,2763885
2011-11,Vermont,865,1710,2575,625741
2011-11,Virginia,14798,19089,33887,8001024
2011-11,Washington,11354,11057,22411,6724540
2011-11,West Virginia,4556,12314,16870,1852994
2011-11,Wisconsin,12245,15947,28192,5686986
2011-11,Wyoming,1501,2232,3733,563626
2011-10,Alabama,9228,12879,22107,4779736
2011-10,Arizona,7915,6449,14364,6392017
2011-10,Arkansas,3654,8444,12098,2915918
2011-10,California,26693,28249,54942,37253956
2011-10,Colorado,11441,13612,25053,5029196
2011-10,Connecticut,3643,3650,7293,3574097
2011-10,Delaware,944,1137,2081,897934
2011-10,District of Columbia,35,0,35,601723
2011-10,Florida,29491,18379,47870,18801310
2011-10,Georgia,7788,11056,18844,9687653
2011-10,Idaho,2051,4538,6589,1567582
2011-10,Illinois,10417,12084,22501,12830632
2011-10,Indiana,10498,12206,22704,6483802
2011-10,Iowa,99,4192,4291,3046355
2011-10,Kansas,4628,6958,11586,2853118
2011-10,Kentucky,6373,10721,17094,4339367
2011-10,Louisiana,7426,13823,21249,4533372
2011-10,Maine,2256,5955,8211,1328361
2011-10,Maryland,3556,5214,8770,5773552
2011-10,Massachusetts,3266,2261,5527,6547629
2011-10,Michigan,1026,13687,14713,9883640
2011-10,Minnesota,5784,17421,23205,5303925
2011-10,Mississippi,3891,8707,12598,2967297
2011-10,Missouri,12526,16426,28952,5988927
2011-10,Montana,2251,6187,8438,989415
2011-10,Nebraska,71,3318,3389,1826341
2011-10,Nevada,3938,3211,7149,2700551
2011-10,New Hampshire,2809,3337,6146,1316470
2011-10,New Jersey,2473,2514,4987,8791894
2011-10,New Mexico,3760,3971,7731,2059179
2011-10,New York,5101,17748,22849,19378102
2011-10,North Carolina,237,14253,14490,9535483
2011-10,North Dakota,1506,5449,6955,672591
2011-10,Ohio,19153,16836,35989,11536504
2011-10,Oklahoma,7583,9610,17193,3751351
2011-10,Oregon,7028,8737,15765,3831074
2011-10,Pennsylvania,26,62938,62964,12702379
2011-10,Rhode Island,646,693,1339,1052567
2011-10,South Carolina,5432,6442,11874,4625364
2011-10,South Dakota,1515,6322,7837,814180
2011-10,Tennessee,13883,14326,28209,6346105
2011-10,Texas,30160,38398,68558,25145561
2011-10,Utah,2102,4032,6134,2763885
2011-10,Vermont,845,1781,2626,625741
2011-10,Virginia,13968,14629,28597,8001024
2011-10,Washington,10657,10328,20985,6724540
2011-10,West Virginia,4643,8595,13238,1852994
2011-10,Wisconsin,9103,14772,23875,5686986
2011-10,Wyoming,1332,1988,3320,563626
2011-09,Alabama,9549,10728,20277,4779736
2011-09,Arizona,7936,6614,14550,6392017
2011-09,Arkansas,4168,6849,11017,2915918
2011-09,California,22197,23657,45854,37253956
2011-09,Colorado,11700,12309,24009,5029196
2011-09,Connecticut,3662,3220,6882,3574097
2011-09,Delaware,830,845,1675,897934
2011-09,District of Columbia,38,1,39,601723
2011-09,Florida,29341,16267,45608,18801310
2011-09,Georgia,8329,8954,17283,9687653
2011-09,Idaho,2207,4158,6365,1567582
2011-09,Illinois,9915,10724,20639,12830632
2011-09,Indiana,9423,10639,20062,6483802
2011-09,Iowa,88,3390,3478,3046355
2011-09,Kansas,3649,5526,9175,2853118
2011-09,Kentucky,6331,8904,15235,4339367
2011-09,Louisiana,8856,15185,24041,4533372
2011-09,Maine,2219,4274,6493,1328361
2011-09,Maryland,3307,3910,7217,5773552
2011-09,Massachusetts,3279,2113,5392,6547629
2011-09,Michigan,945,12997,13942,9883640
2011-09,Minnesota,5492,15315,20807,5303925
2011-09,Mississippi,3739,7119,10858,2967297
2011-09,Missouri,12359,12894,25253,5988927
2011-09,Montana,2442,5001,7443,989415
2011-09,Nebraska,81,2324,2405,1826341
2011-09,Nevada,4048,3066,7114,2700551
2011-09,New Hampshire,2928,2776,5704,1316470
2011-09,New Jersey,2403,2200,4603,8791894
2011-09,New Mexico,3428,3596,7024,2059179
2011-09,New York,4894,16404,21298,19378102
2011-09,North Carolina,257,11602,11859,9535483
2011-09,North Dakota,1203,3905,5108,672591
2011-09,Ohio,17864,14411,32275,11536504
2011-09,Oklahoma,7612,8896,16508,3751351
2011-09,Oregon,6952,9093,16045,3831074
2011-09,Pennsylvania,0,58431,58431,12702379
2011-09,Rhode Island,660,580,1240,1052567
2011-09,South Carolina,5551,5992,11543,4625364
2011-09,South Dakota,1478,4011,5489,814180
2011-09,Tennessee,13175,12204,25379,6346105
2011-09,Texas,29410,41207,70617,25145561
2011-09,Utah,2286,3979,6265,2763885
2011-09,Vermont,924,1430,2354,625741
2011-09,Virginia,12701,12134,24835,8001024
2011-09,Washington,9924,9314,19238,6724540
2011-09,West Virginia,4378,7055,11433,1852994
2011-09,Wisconsin,8176,12953,21129,5686986
2011-09,Wyoming,1531,2206,3737,563626
2011-08,Alabama,9863,10576,20439,4779736
2011-08,Arizona,7684,6476,14160,6392017
2011-08,Arkansas,3651,5251,8902,2915918
2011-08,California,23431,27619,51050,37253956
2011-08,Colorado,11775,11469,23244,5029196
2011-08,Connecticut,3912,2964,6876,3574097
2011-08,Delaware,770,713,1483,897934
2011-08,District of Columbia,11,0,11,601723
2011-08,Florida,29668,15927,45595,18801310
2011-08,Georgia,8237,7957,16194,9687653
2011-08,Idaho,2068,3527,5595,1567582
2011-08,Illinois,9947,10717,20664,12830632
2011-08,Indiana,9898,9924,19822,6483802
2011-08,Iowa,69,2629,2698,3046355
2011-08,Kansas,4080,5373,9453,2853118
2011-08,Kentucky,6336,7407,13743,4339367
2011-08,Louisiana,7465,10194,17659,4533372
2011-08,Maine,2089,3125,5214,1328361
2011-08,Maryland,3647,3950,7597,5773552
2011-08,Massachusetts,3484,2114,5598,6547629
2011-08,Michigan,986,10367,11353,9883640
2011-08,Minnesota,5288,10716,16004,5303925
2011-08,Mississippi,4273,6099,10372,2967297
2011-08,Missouri,12579,11701,24280,5988927
2011-08,Montana,2425,3871,6296,989415
2011-08,Nebraska,85,2189,2274,1826341
2011-08,Nevada,4140,3276,7416,2700551
2011-08,New Hampshire,2589,2260,4849,1316470
2011-08,New Jersey,2426,2047,4473,8791894
2011-08,New Mexico,3758,3518,7276,2059179
2011-08,New York,4973,11860,16833,19378102
2011-08,North Carolina,245,10475,10720,9535483
2011-08,North Dakota,1346,2869,4215,672591
2011-08,Ohio,17325,13410,30735,11536504
2011-08,Oklahoma,8132,8191,16323,3751351
2011-08,Oregon,6591,7234,13825,3831074
2011-08,Pennsylvania,6,54551,54557,12702379
2011-08,Rhode Island,686,576,1262,1052567
2011-08,South Carolina,5638,5374,11012,4625364
2011-08,South Dakota,1595,3239,4834,814180
2011-08,Tennessee,13887,12061,25948,6346105
2011-08,Texas,30112,35200,65312,25145561
2011-08,Utah,2198,3042,5240,2763885
2011-08,Vermont,833,1087,1920,625741
2011-08,Virginia,12084,10470,22554,8001024
2011-08,Washington,10265,8597,18862,6724540
2011-08,West Virginia,4306,5530,9836,1852994
2011-08,Wisconsin,8254,10196,18450,5686986
2011-08,Wyoming,1361,1840,3201,563626
2011-07,Alabama,8988,8152,17140,4779736
2011-07,Arizona,7367,4997,12364,6392017
2011-07,Arkansas,3504,3806,7310,2915918
2011-07,California,21925,21196,43121,37253956
2011-07,Colorado,10070,8781,18851,5029196
2011-07,Connecticut,3390,2501,5891,3574097
2011-07,Delaware,737,561,1298,897934
2011-07,District of Columbia,3,0,3,601723
2011-07,Florida,27240,13412,40652,18801310
2011-07,Georgia,7543,5779,13322,9687653
2011-07,Idaho,1798,2685,4483,1567582
2011-07,Illinois,8812,7396,16208,12830632
2011-07,Indiana,8622,6938,15560,6483802
2011-07,Iowa,37,1812,1849,3046355
2011-07,Kansas,3629,3734,7363,2853118
2011-07,Kentucky,5763,5421,11184,4339367
2011-07,Louisiana,7296,6809,14105,4533372
2011-07,Maine,1952,2629,4581,1328361
2011-07,Maryland,3086,3197,6283,5773552
2011-07,Massachusetts,3114,1600,4714,6547629
2011-07,Michigan,1040,6613,7653,9883640
2011-07,Minnesota,4214,6233,10447,5303925
2011-07,Mississippi,3772,3919,7691,2967297
2011-07,Missouri,11070,8276,19346,5988927
2011-07,Montana,2157,3281,5438,989415
2011-07,Nebraska,56,1331,1387,1826341
2011-07,Nevada,3816,2804,6620,2700551
2011-07,New Hampshire,2411,1990,4401,1316470
2011-07,New Jersey,2449,1754,4203,8791894
2011-07,New Mexico,3167,2890,6057,2059179
2011-07,New York,4069,8408,12477,19378102
2011-07,North Carolina,242,7556,7798,9535483
2011-07,North Dakota,947,2007,2954,672591
2011-07,Ohio,15404,10937,26341,11536504
2011-07,Oklahoma,7373,6184,13557,3751351
2011-07,Oregon,6289,6345,12634,3831074
2011-07,Pennsylvania,0,45503,45503,12702379
2011-07,Rhode Island,570,437,1007,1052567
2011-07,South Carolina,4797,3631,8428,4625364
2011-07,South Dakota,1227,2133,3360,814180
2011-07,Tennessee,12455,8834,21289,6346105
2011-07,Texas,28000,24870,52870,25145561
2011-07,Utah,1956,2536,4492,2763885
2011-07,Vermont,731,777,1508,625741
2011-07,Virginia,13419,9388,22807,8001024
2011-07,Washington,9471,7452,16923,6724540
2011-07,West Virginia,3890,4236,8126,1852994
2011-07,Wisconsin,7359,6356,13715,5686986
2011-07,Wyoming,1269,1485,2754,563626
2011-06,Alabama,9388,7951,17339,4779736
2011-06,Arizona,7204,4908,12112,6392017
2011-06,Arkansas,3496,3390,6886,2915918
2011-06,California,24632,24012,48644,37253956
2011-06,Colorado,10394,9130,19524,5029196
2011-06,Connecticut,3866,2510,6376,3574097
2011-06,Delaware,732,597,1329,897934
2011-06,District of Columbia,6,0,6,601723
2011-06,Florida,27744,13091,40835,18801310
2011-06,Georgia,7746,5227,12973,9687653
2011-06,Idaho,1918,3067,4985,1567582
2011-06,Illinois,9059,7372,16431,12830632
2011-06,Indiana,8876,6861,15737,6483802
2011-06,Iowa,43,1803,1846,3046355
2011-06,Kansas,3434,3369,6803,2853118
2011-06,Kentucky,5729,5255,10984,4339367
2011-06,Louisiana,7322,5973,13295,4533372
2011-06,Maine,1945,2184,4129,1328361
2011-06,Maryland,3277,2896,6173,5773552
2011-06,Massachusetts,3143,1598,4741,6547629
2011-06,Michigan,1177,6719,7896,9883640
2011-06,Minnesota,4862,6241,11103,5303925
2011-06,Mississippi,3541,3283,6824,2967297
2011-06,Missouri,11684,7896,19580,5988927
2011-06,Montana,2154,3325,5479,989415
2011-06,Nebraska,73,1357,1430,1826341
2011-06,Nevada,3756,2919,6675,2700551
2011-06,New Hampshire,2373,1941,4314,1316470
2011-06,New Jersey,2586,1806,4392,8791894
2011-06,New Mexico,3492,2877,6369,2059179
2011-06,New York,4850,8697,13547,19378102
2011-06,North Carolina,241,7371,7612,9535483
2011-06,North Dakota,895,2010,2905,672591
2011-06,Ohio,15226,9991,25217,11536504
2011-06,Oklahoma,7401,5743,13144,3751351
2011-06,Oregon,7074,7264,14338,3831074
2011-06,Pennsylvania,1,46047,46048,12702379
2011-06,Rhode Island,605,493,1098,1052567
2011-06,South Carolina,5043,3281,8324,4625364
2011-06,South Dakota,1349,2127,3476,814180
2011-06,Tennessee,12513,7998,20511,6346105
2011-06,Texas,28911,23268,52179,25145561
2011-06,Utah,2109,2798,4907,2763885
2011-06,Vermont,801,872,1673,625741
2011-06,Virginia,10945,7884,18829,8001024
2011-06,Washington,9852,7829,17681,6724540
2011-06,West Virginia,3924,3799,7723,1852994
2011-06,Wisconsin,6548,6686,13234,5686986
2011-06,Wyoming,1379,1541,2920,563626
2011-05,Alabama,8950,7192,16142,4779736
2011-05,Arizona,7868,5278,13146,6392017
2011-05,Arkansas,3659,3438,7097,2915918
2011-05,California,22849,22801,45650,37253956
2011-05,Colorado,11276,9670,20946,5029196
2011-05,Connecticut,4046,2754,6800,3574097
2011-05,Delaware,743,624,1367,897934
2011-05,District of Columbia,14,1,15,601723
2011-05,Florida,27882,12952,40834,18801310
2011-05,Georgia,7930,5154,13084,9687653
2011-05,Idaho,1989,3283,5272,1567582
2011-05,Illinois,9700,8132,17832,12830632
2011-05,Indiana,8658,7073,15731,6483802
2011-05,Iowa,46,1809,1855,3046355
2011-05,Kansas,3852,3713,7565,2853118
2011-05,Kentucky,5872,5437,11309,4339367
2011-05,Louisiana,6884,5585,12469,4533372
2011-05,Maine,1926,2376,4302,1328361
2011-05,Maryland,3630,3093,6723,5773552
2011-05,Massachusetts,3308,1533,4841,6547629
2011-05,Michigan,1222,7634,8856,9883640
2011-05,Minnesota,5661,6988,12649,5303925
2011-05,Mississippi,3738,3252,6990,2967297
2011-05,Missouri,12186,8850,21036,5988927
2011-05,Montana,2340,3613,5953,989415
2011-05,Nebraska,78,1555,1633,1826341
2011-05,Nevada,4375,3208,7583,2700551
2011-05,New Hampshire,2341,2134,4475,1316470
2011-05,New Jersey,2733,1908,4641,8791894
2011-05,New Mexico,3627,2940,6567,2059179
2011-05,New York,5153,9953,15106,19378102
2011-05,North Carolina,222,7265,7487,9535483
2011-05,North Dakota,1086,2288,3374,672591
2011-05,Ohio,17056,10842,27898,11536504
2011-05,Oklahoma,7472,5659,13131,3751351
2011-05,Oregon,8047,8145,16192,3831074
2011-05,Pennsylvania,3,48124,48127,12702379
2011-05,Rhode Island,625,471,1096,1052567
2011-05,South Carolina,4951,3294,8245,4625364
2011-05,South Dakota,1464,2445,3909,814180
2011-05,Tennessee,12655,7927,20582,6346105
2011-05,Texas,29323,24239,53562,25145561
2011-05,Utah,2268,3094,5362,2763885
2011-05,Vermont,895,887,1782,625741
2011-05,Virginia,11938,8266,20204,8001024
2011-05,Washington,10296,8059,18355,6724540
2011-05,West Virginia,4023,4109,8132,1852994
2011-05,Wisconsin,6414,7485,13899,5686986
2011-05,Wyoming,1435,1768,3203,563626
2011-04,Alabama,9332,8242,17574,4779736
2011-04,Arizona,9411,6361,15772,6392017
2011-04,Arkansas,4180,4296,8476,2915918
2011-04,California,30345,29788,60133,37253956
2011-04,Colorado,12616,11577,24193,5029196
2011-04,Connecticut,4600,3579,8179,3574097
2011-04,Delaware,898,738,1636,897934
2011-04,District of Columbia,36,1,37,601723
2011-04,Florida,30697,14985,45682,18801310
2011-04,Georgia,8447,6021,14468,9687653
2011-04,Idaho,2434,4051,6485,1567582
2011-04,Illinois,11468,9467,20935,12830632
2011-04,Indiana,10938,9339,20277,6483802
2011-04,Iowa,59,2984,3043,3046355
2011-04,Kansas,5097,4813,9910,2853118
2011-04,Kentucky,7336,7619,14955,4339367
2011-04,Louisiana,7733,5914,13647,4533372
2011-04,Maine,2459,2865,5324,1328361
2011-04,Maryland,4226,4002,8228,5773552
2011-04,Massachusetts,4001,2211,6212,6547629
2011-04,Michigan,1640,10169,11809,9883640
2011-04,Minnesota,7478,11302,18780,5303925
2011-04,Mississippi,4367,3689,8056,2967297
2011-04,Missouri,14435,11840,26275,5988927
2011-04,Montana,2637,4230,6867,989415
2011-04,Nebraska,144,1878,2022,1826341
2011-04,Nevada,4410,3383,7793,2700551
2011-04,New Hampshire,3045,2850,5895,1316470
2011-04,New Jersey,2874,2363,5237,8791894
2011-04,New Mexico,3988,3516,7504,2059179
2011-04,New York,6408,13721,20129,19378102
2011-04,North Carolina,295,8863,9158,9535483
2011-04,North Dakota,1347,3022,4369,672591
2011-04,Ohio,21622,14325,35947,11536504
2011-04,Oklahoma,9396,7599,16995,3751351
2011-04,Oregon,8906,9231,18137,3831074
2011-04,Pennsylvania,2,61720,61722,12702379
2011-04,Rhode Island,835,617,1452,1052567
2011-04,South Carolina,6075,4063,10138,4625364
2011-04,South Dakota,1880,3050,4930,814180
2011-04,Tennessee,13983,9779,23762,6346105
2011-04,Texas,31570,25708,57278,25145561
2011-04,Utah,3009,3589,6598,2763885
2011-04,Vermont,1039,1508,2547,625741
2011-04,Virginia,15008,10407,25415,8001024
2011-04,Washington,11843,9640,21483,6724540
2011-04,West Virginia,5067,5560,10627,1852994
2011-04,Wisconsin,7165,11960,19125,5686986
2011-04,Wyoming,1650,1870,3520,563626
2011-03,Alabama,12176,10579,22755,4779736
2011-03,Arizona,11393,7362,18755,6392017
2011-03,Arkansas,6184,5909,12093,2915918
2011-03,California,29994,30323,60317,37253956
2011-03,Colorado,14811,13223,28034,5029196
2011-03,Connecticut,5267,4147,9414,3574097
2011-03,Delaware,1215,855,2070,897934
2011-03,District of Columbia,37,2,39,601723
2011-03,Florida,35962,17283,53245,18801310
2011-03,Georgia,12130,8096,20226,9687653
2011-03,Idaho,3003,4379,7382,1567582
2011-03,Illinois,14745,12428,27173,12830632
2011-03,Indiana,15597,11489,27086,6483802
2011-03,Iowa,91,4095,4186,3046355
2011-03,Kansas,7648,6940,14588,2853118
2011-03,Kentucky,9757,9133,18890,4339367
2011-03,Louisiana,9488,7465,16953,4533372
2011-03,Maine,2931,3350,6281,1328361
2011-03,Maryland,5037,4274,9311,5773552
2011-03,Massachusetts,4439,2536,6975,6547629
2011-03,Michigan,1859,12837,14696,9883640
2011-03,Minnesota,7850,11543,19393,5303925
2011-03,Mississippi,5510,5256,10766,2967297
2011-03,Missouri,18610,13979,32589,5988927
2011-03,Montana,3072,4283,7355,989415
2011-03,Nebraska,164,2463,2627,1826341
2011-03,Nevada,5549,4111,9660,2700551
2011-03,New Hampshire,3272,2586,5858,1316470
2011-03,New Jersey,3052,2530,5582,8791894
2011-03,New Mexico,4532,4054,8586,2059179
2011-03,New York,7472,14201,21673,19378102
2011-03,North Carolina,356,10789,11145,9535483
2011-03,North Dakota,1473,2757,4230,672591
2011-03,Ohio,26107,16404,42511,11536504
2011-03,Oklahoma,10439,8267,18706,3751351
2011-03,Oregon,9969,10516,20485,3831074
2011-03,Pennsylvania,0,71904,71904,12702379
2011-03,Rhode Island,947,675,1622,1052567
2011-03,South Carolina,8202,5130,13332,4625364
2011-03,South Dakota,2256,3395,5651,814180
2011-03,Tennessee,18753,11979,30732,6346105
2011-03,Texas,39750,29342,69092,25145561
2011-03,Utah,3114,3983,7097,2763885
2011-03,Vermont,1226,1538,2764,625741
2011-03,Virginia,18229,11780,30009,8001024
2011-03,Washington,14066,10800,24866,6724540
2011-03,West Virginia,6516,6212,12728,1852994
2011-03,Wisconsin,8867,13950,22817,5686986
2011-03,Wyoming,2055,2079,4134,563626
2011-02,Alabama,13689,11452,25141,4779736
2011-02,Arizona,11824,6910,18734,6392017
2011-02,Arkansas,6696,6462,13158,2915918
2011-02,California,24348,24119,48467,37253956
2011-02,Colorado,13470,11548,25018,5029196
2011-02,Connecticut,4386,3402,7788,3574097
2011-02,Delaware,1011,794,1805,897934
2011-02,District of Columbia,31,2,33,601723
2011-02,Florida,37890,18121,56011,18801310
2011-02,Georgia,14936,9401,24337,9687653
2011-02,Idaho,2623,3710,6333,1567582
2011-02,Illinois,11644,10778,22422,12830632
2011-02,Indiana,13991,9923,23914,6483802
2011-02,Iowa,98,3332,3430,3046355
2011-02,Kansas,6796,6162,12958,2853118
2011-02,Kentucky,11819,10032,21851,4339367
2011-02,Louisiana,10137,7948,18085,4533372
2011-02,Maine,2162,2379,4541,1328361
2011-02,Maryland,4183,4158,8341,5773552
2011-02,Massachusetts,3293,1637,4930,6547629
2011-02,Michigan,1541,9781,11322,9883640
2011-02,Minnesota,6272,8218,14490,5303925
2011-02,Mississippi,6920,6109,13029,2967297
2011-02,Missouri,16363,12602,28965,5988927
2011-02,Montana,2479,3348,5827,989415
2011-02,Nebraska,117,2170,2287,1826341
2011-02,Nevada,5043,3362,8405,2700551
2011-02,New Hampshire,2685,1941,4626,1316470
2011-02,New Jersey,2467,1950,4417,8791894
2011-02,New Mexico,4609,3979,8588,2059179
2011-02,New York,5940,11375,17315,19378102
2011-02,North Carolina,359,12774,13133,9535483
2011-02,North Dakota,1268,2264,3532,672591
2011-02,Ohio,24197,14456,38653,11536504
2011-02,Oklahoma,10419,8244,18663,3751351
2011-02,Oregon,9061,9173,18234,3831074
2011-02,Pennsylvania,0,59739,59739,12702379
2011-02,Rhode Island,812,596,1408,1052567
2011-02,South Carolina,10531,5714,16245,4625364
2011-02,South Dakota,1915,3108,5023,814180
2011-02,Tennessee,21069,13707,34776,6346105
2011-02,Texas,41341,29888,71229,25145561
2011-02,Utah,2916,3402,6318,2763885
2011-02,Vermont,1119,1150,2269,625741
2011-02,Virginia,19068,12222,31290,8001024
2011-02,Washington,12701,9663,22364,6724540
2011-02,West Virginia,6537,6450,12987,1852994
2011-02,Wisconsin,7023,9639,16662,5686986
2011-02,Wyoming,1556,1908,3464,563626
2011-01,Alabama,10128,9747,19875,4779736
2011-01,Arizona,9310,6084,15394,6392017
2011-01,Arkansas,4545,5179,9724,2915918
2011-01,California,23418,22708,46126,37253956
2011-01,Colorado,11705,10191,21896,5029196
2011-01,Connecticut,3956,3241,7197,3574097
2011-01,Delaware,845,646,1491,897934
2011-01,District of Columbia,17,0,17,601723
2011-01,Florida,32684,16731,49415,18801310
2011-01,Georgia,9240,7227,16467,9687653
2011-01,Idaho,2023,3135,5158,1567582
2011-01,Illinois,10486,9844,20330,12830632
2011-01,Indiana,11783,8704,20487,6483802
2011-01,Iowa,86,3028,3114,3046355
2011-01,Kansas,5676,5696,11372,2853118
2011-01,Kentucky,7773,7003,14776,4339367
2011-01,Louisiana,8332,9008,17340,4533372
2011-01,Maine,1953,2308,4261,1328361
2011-01,Maryland,3620,3639,7259,5773552
2011-01,Massachusetts,3305,1646,4951,6547629
2011-01,Michigan,1389,7927,9316,9883640
2011-01,Minnesota,5154,6960,12114,5303925
2011-01,Mississippi,4208,5596,9804,2967297
2011-01,Missouri,14075,11247,25322,5988927
2011-01,Montana,1850,2760,4610,989415
2011-01,Nebraska,139,2296,2435,1826341
2011-01,Nevada,4324,3067,7391,2700551
2011-01,New Hampshire,2597,1842,4439,1316470
2011-01,New Jersey,2268,1759,4027,8791894
2011-01,New Mexico,3527,3147,6674,2059179
2011-01,New York,5387,9811,15198,19378102
2011-01,North Carolina,297,9911,10208,9535483
2011-01,North Dakota,930,2094,3024,672591
2011-01,Ohio,18305,11163,29468,11536504
2011-01,Oklahoma,10078,7959,18037,3751351
2011-01,Oregon,7234,7247,14481,3831074
2011-01,Pennsylvania,0,48470,48470,12702379
2011-01,Rhode Island,669,495,1164,1052567
2011-01,South Carolina,6022,4495,10517,4625364
2011-01,South Dakota,1605,3000,4605,814180
2011-01,Tennessee,15601,10436,26037,6346105
2011-01,Texas,34251,28911,63162,25145561
2011-01,Utah,2628,3024,5652,2763885
2011-01,Vermont,800,822,1622,625741
2011-01,Virginia,13928,10089,24017,8001024
2011-01,Washington,10723,8083,18806,6724540
2011-01,West Virginia,4288,4997,9285,1852994
2011-01,Wisconsin,5558,7388,12946,5686986
2011-01,Wyoming,1167,1414,2581,563626
2010-12,Alabama,13978,24298,38276,4779736
2010-12,Arizona,9943,9814,19757,6392017
2010-12,Arkansas,5816,12455,18271,2915918
2010-12,California,24519,32100,56619,37253956
2010-12,Colorado,13951,16894,30845,5029196
2010-12,Connecticut,4371,4349,8720,3574097
2010-12,Delaware,1003,1355,2358,897934
2010-12,District of Columbia,25,2,27,601723
2010-12,Florida,34196,27204,61400,18801310
2010-12,Georgia,12171,18708,30879,9687653
2010-12,Idaho,2652,5717,8369,1567582
2010-12,Illinois,11217,14646,25863,12830632
2010-12,Indiana,11672,15692,27364,6483802
2010-12,Iowa,76,6065,6141,3046355
2010-12,Kansas,6722,10496,17218,2853118
2010-12,Kentucky,10109,16321,26430,4339367
2010-12,Louisiana,10731,22440,33171,4533372
2010-12,Maine,2281,4165,6446,1328361
2010-12,Maryland,3425,6020,9445,5773552
2010-12,Massachusetts,3378,2213,5591,6547629
2010-12,Michigan,1559,14969,16528,9883640
2010-12,Minnesota,5236,11147,16383,5303925
2010-12,Mississippi,5900,17019,22919,2967297
2010-12,Missouri,15736,19623,35359,5988927
2010-12,Montana,2666,5315,7981,989415
2010-12,Nebraska,172,4618,4790,1826341
2010-12,Nevada,5046,4759,9805,2700551
2010-12,New Hampshire,2809,2747,5556,1316470
2010-12,New Jersey,2004,2778,4782,8791894
2010-12,New Mexico,4431,5658,10089,2059179
2010-12,New York,5392,16569,21961,19378102
2010-12,North Carolina,361,22141,22502,9535483
2010-12,North Dakota,984,3091,4075,672591
2010-12,Ohio,21429,22061,43490,11536504
2010-12,Oklahoma,11050,14617,25667,3751351
2010-12,Oregon,8088,12091,20179,3831074
2010-12,Pennsylvania,0,63195,63195,12702379
2010-12,Rhode Island,746,606,1352,1052567
2010-12,South Carolina,7545,11109,18654,4625364
2010-12,South Dakota,1826,4931,6757,814180
2010-12,Tennessee,18915,22001,40916,6346105
2010-12,Texas,43197,60696,103893,25145561
2010-12,Utah,3663,6960,10623,2763885
2010-12,Vermont,916,1391,2307,625741
2010-12,Virginia,14577,17746,32323,8001024
2010-12,Washington,12032,12873,24905,6724540
2010-12,West Virginia,5752,10146,15898,1852994
2010-12,Wisconsin,5978,11367,17345,5686986
2010-12,Wyoming,1783,2838,4621,563626
2010-11,Alabama,9943,17513,27456,4779736
2010-11,Arizona,7006,6547,13553,6392017
2010-11,Arkansas,3899,10722,14621,2915918
2010-11,California,18478,24984,43462,37253956
2010-11,Colorado,9975,12773,22748,5029196
2010-11,Connecticut,3878,3972,7850,3574097
2010-11,Delaware,805,1212,2017,897934
2010-11,District of Columbia,21,0,21,601723
2010-11,Florida,27691,19404,47095,18801310
2010-11,Georgia,7602,11566,19168,9687653
2010-11,Idaho,1692,3661,5353,1567582
2010-11,Illinois,9128,13938,23066,12830632
2010-11,Indiana,8862,14956,23818,6483802
2010-11,Iowa,40,6199,6239,3046355
2010-11,Kansas,4980,8773,13753,2853118
2010-11,Kentucky,6776,13152,19928,4339367
2010-11,Louisiana,7413,16069,23482,4533372
2010-11,Maine,1855,3824,5679,1328361
2010-11,Maryland,3175,6327,9502,5773552
2010-11,Massachusetts,2569,2280,4849,6547629
2010-11,Michigan,1303,17554,18857,9883640
2010-11,Minnesota,4196,11475,15671,5303925
2010-11,Mississippi,4088,13772,17860,2967297
2010-11,Missouri,11684,17214,28898,5988927
2010-11,Montana,1767,3879,5646,989415
2010-11,Nebraska,91,3930,4021,1826341
2010-11,Nevada,3774,3365,7139,2700551
2010-11,New Hampshire,2412,2639,5051,1316470
2010-11,New Jersey,2102,2903,5005,8791894
2010-11,New Mexico,3186,3819,7005,2059179
2010-11,New York,4811,18366,23177,19378102
2010-11,North Carolina,275,16136,16411,9535483
2010-11,North Dakota,792,3071,3863,672591
2010-11,Ohio,16886,22161,39047,11536504
2010-11,Oklahoma,8321,11041,19362,3751351
2010-11,Oregon,5850,8826,14676,3831074
2010-11,Pennsylvania,1,67043,67044,12702379
2010-11,Rhode Island,652,570,1222,1052567
2010-11,South Carolina,7017,8934,15951,4625364
2010-11,South Dakota,1312,4787,6099,814180
2010-11,Tennessee,14304,17217,31521,6346105
2010-11,Texas,31451,40228,71679,25145561
2010-11,Utah,2500,4273,6773,2763885
2010-11,Vermont,629,1615,2244,625741
2010-11,Virginia,12715,16299,29014,8001024
2010-11,Washington,9230,8812,18042,6724540
2010-11,West Virginia,3991,10722,14713,1852994
2010-11,Wisconsin,5242,15123,20365,5686986
2010-11,Wyoming,1082,1911,2993,563626
2010-10,Alabama,8410,12198,20608,4779736
2010-10,Arizona,7142,5384,12526,6392017
2010-10,Arkansas,3462,7811,11273,2915918
2010-10,California,21351,22352,43703,37253956
2010-10,Colorado,10017,11714,21731,5029196
2010-10,Connecticut,3782,3840,7622,3574097
2010-10,Delaware,735,947,1682,897934
2010-10,District of Columbia,25,1,26,601723
2010-10,Florida,26902,15965,42867,18801310
2010-10,Georgia,7606,10062,17668,9687653
2010-10,Idaho,1798,4213,6011,1567582
2010-10,Illinois,8918,10462,19380,12830632
2010-10,Indiana,9477,11402,20879,6483802
2010-10,Iowa,42,4289,4331,3046355
2010-10,Kansas,4950,6760,11710,2853118
2010-10,Kentucky,6796,9734,16530,4339367
2010-10,Louisiana,6792,14282,21074,4533372
2010-10,Maine,2141,5938,8079,1328361
2010-10,Maryland,2997,4430,7427,5773552
2010-10,Massachusetts,2805,2099,4904,6547629
2010-10,Michigan,1301,13893,15194,9883640
2010-10,Minnesota,5018,17640,22658,5303925
2010-10,Mississippi,3761,8297,12058,2967297
2010-10,Missouri,11534,15056,26590,5988927
2010-10,Montana,1902,5855,7757,989415
2010-10,Nebraska,89,3338,3427,1826341
2010-10,Nevada,3529,2744,6273,2700551
2010-10,New Hampshire,2570,3131,5701,1316470
2010-10,New Jersey,2122,2223,4345,8791894
2010-10,New Mexico,3322,3385,6707,2059179
2010-10,New York,5056,16813,21869,19378102
2010-10,North Carolina,230,11897,12127,9535483
2010-10,North Dakota,879,4913,5792,672591
2010-10,Ohio,16955,14932,31887,11536504
2010-10,Oklahoma,6962,8168,15130,3751351
2010-10,Oregon,6053,8402,14455,3831074
2010-10,Pennsylvania,1,56795,56796,12702379
2010-10,Rhode Island,625,578,1203,1052567
2010-10,South Carolina,4512,5403,9915,4625364
2010-10,South Dakota,1360,6299,7659,814180
2010-10,Tennessee,12943,12387,25330,6346105
2010-10,Texas,25858,33053,58911,25145561
2010-10,Utah,1995,3593,5588,2763885
2010-10,Vermont,776,1757,2533,625741
2010-10,Virginia,12655,12674,25329,8001024
2010-10,Washington,9138,9407,18545,6724540
2010-10,West Virginia,4156,8515,12671,1852994
2010-10,Wisconsin,5887,15155,21042,5686986
2010-10,Wyoming,938,1922,2860,563626
2010-09,Alabama,8294,10525,18819,4779736
2010-09,Arizona,7342,5704,13046,6392017
2010-09,Arkansas,3619,6236,9855,2915918
2010-09,California,18221,20434,38655,37253956
2010-09,Colorado,9991,10435,20426,5029196
2010-09,Connecticut,3678,3328,7006,3574097
2010-09,Delaware,717,808,1525,897934
2010-09,District of Columbia,27,1,28,601723
2010-09,Florida,25405,13802,39207,18801310
2010-09,Georgia,6953,7373,14326,9687653
2010-09,Idaho,1886,4020,5906,1567582
2010-09,Illinois,8469,9115,17584,12830632
2010-09,Indiana,8301,8792,17093,6483802
2010-09,Iowa,35,3312,3347,3046355
2010-09,Kansas,4118,5348,9466,2853118
2010-09,Kentucky,6340,7758,14098,4339367
2010-09,Louisiana,8185,13822,22007,4533372
2010-09,Maine,2072,4309,6381,1328361
2010-09,Maryland,2859,3701,6560,5773552
2010-09,Massachusetts,2501,1839,4340,6547629
2010-09,Michigan,1213,12889,14102,9883640
2010-09,Minnesota,4832,15363,20195,5303925
2010-09,Mississippi,3556,6433,9989,2967297
2010-09,Missouri,11250,11432,22682,5988927
2010-09,Montana,2109,4679,6788,989415
2010-09,Nebraska,65,2418,2483,1826341
2010-09,Nevada,3393,2757,6150,2700551
2010-09,New Hampshire,2321,2615,4936,1316470
2010-09,New Jersey,2033,1972,4005,8791894
2010-09,New Mexico,3302,3324,6626,2059179
2010-09,New York,4967,14319,19286,19378102
2010-09,North Carolina,207,9925,10132,9535483
2010-09,North Dakota,818,3270,4088,672591
2010-09,Ohio,14875,12466,27341,11536504
2010-09,Oklahoma,6721,6944,13665,3751351
2010-09,Oregon,6389,9154,15543,3831074
2010-09,Pennsylvania,0,51739,51739,12702379
2010-09,Rhode Island,588,506,1094,1052567
2010-09,South Carolina,4892,5055,9947,4625364
2010-09,South Dakota,1362,4227,5589,814180
2010-09,Tennessee,12033,10387,22420,6346105
2010-09,Texas,24093,34038,58131,25145561
2010-09,Utah,2045,3423,5468,2763885
2010-09,Vermont,849,1451,2300,625741
2010-09,Virginia,11106,10776,21882,8001024
2010-09,Washington,8816,9005,17821,6724540
2010-09,West Virginia,3630,6102,9732,1852994
2010-09,Wisconsin,5199,12920,18119,5686986
2010-09,Wyoming,1120,2036,3156,563626
2010-08,Alabama,9180,10361,19541,4779736
2010-08,Arizona,7333,5615,12948,6392017
2010-08,Arkansas,3431,4670,8101,2915918
2010-08,California,18686,22110,40796,37253956
2010-08,Colorado,11216,10872,22088,5029196
2010-08,Connecticut,3786,3259,7045,3574097
2010-08,Delaware,698,687,1385,897934
2010-08,District of Columbia,21,0,21,601723
2010-08,Florida,25610,13532,39142,18801310
2010-08,Georgia,7000,6602,13602,9687653
2010-08,Idaho,1763,3249,5012,1567582
2010-08,Illinois,8621,8960,17581,12830632
2010-08,Indiana,9467,8859,18326,6483802
2010-08,Iowa,40,2496,2536,3046355
2010-08,Kansas,4222,4949,9171,2853118
2010-08,Kentucky,5882,6494,12376,4339367
2010-08,Louisiana,7036,9750,16786,4533372
2010-08,Maine,1751,3005,4756,1328361
2010-08,Maryland,3378,3256,6634,5773552
2010-08,Massachusetts,2805,1673,4478,6547629
2010-08,Michigan,1266,9877,11143,9883640
2010-08,Minnesota,4782,10143,14925,5303925
2010-08,Mississippi,3999,5824,9823,2967297
2010-08,Missouri,11357,10602,21959,5988927
2010-08,Montana,2443,3940,6383,989415
2010-08,Nebraska,51,2127,2178,1826341
2010-08,Nevada,3608,2911,6519,2700551
2010-08,New Hampshire,2247,2050,4297,1316470
2010-08,New Jersey,1975,1746,3721,8791894
2010-08,New Mexico,3488,3155,6643,2059179
2010-08,New York,4713,10271,14984,19378102
2010-08,North Carolina,223,9248,9471,9535483
2010-08,North Dakota,805,2342,3147,672591
2010-08,Ohio,14235,11330,25565,11536504
2010-08,Oklahoma,7200,6992,14192,3751351
2010-08,Oregon,6148,6995,13143,3831074
2010-08,Pennsylvania,0,47082,47082,12702379
2010-08,Rhode Island,586,479,1065,1052567
2010-08,South Carolina,4466,4578,9044,4625364
2010-08,South Dakota,1270,3064,4334,814180
2010-08,Tennessee,12546,10049,22595,6346105
2010-08,Texas,25618,30875,56493,25145561
2010-08,Utah,1873,2778,4651,2763885
2010-08,Vermont,693,964,1657,625741
2010-08,Virginia,11857,10207,22064,8001024
2010-08,Washington,9030,7578,16608,6724540
2010-08,West Virginia,3601,4766,8367,1852994
2010-08,Wisconsin,5110,9711,14821,5686986
2010-08,Wyoming,1160,1636,2796,563626
2010-07,Alabama,8451,7714,16165,4779736
2010-07,Arizona,6933,4405,11338,6392017
2010-07,Arkansas,3377,3587,6964,2915918
2010-07,California,19019,19505,38524,37253956
2010-07,Colorado,9883,8632,18515,5029196
2010-07,Connecticut,3522,2507,6029,3574097
2010-07,Delaware,680,557,1237,897934
2010-07,District of Columbia,31,0,31,601723
2010-07,Florida,25729,12007,37736,18801310
2010-07,Georgia,6734,4676,11410,9687653
2010-07,Idaho,1638,2511,4149,1567582
2010-07,Illinois,7950,6957,14907,12830632
2010-07,Indiana,7672,6279,13951,6483802
2010-07,Iowa,50,1700,1750,3046355
2010-07,Kansas,3951,3402,7353,2853118
2010-07,Kentucky,5885,5426,11311,4339367
2010-07,Louisiana,6805,6112,12917,4533372
2010-07,Maine,1583,2207,3790,1328361
2010-07,Maryland,3147,2703,5850,5773552
2010-07,Massachusetts,2412,1491,3903,6547629
2010-07,Michigan,1264,6504,7768,9883640
2010-07,Minnesota,4091,6283,10374,5303925
2010-07,Mississippi,3685,3750,7435,2967297
2010-07,Missouri,10845,7545,18390,5988927
2010-07,Montana,1957,2960,4917,989415
2010-07,Nebraska,79,1348,1427,1826341
2010-07,Nevada,3329,2336,5665,2700551
2010-07,New Hampshire,2152,2137,4289,1316470
2010-07,New Jersey,2107,1547,3654,8791894
2010-07,New Mexico,3225,2778,6003,2059179
2010-07,New York,4496,8367,12863,19378102
2010-07,North Carolina,240,7092,7332,9535483
2010-07,North Dakota,676,1728,2404,672591
2010-07,Ohio,14141,9700,23841,11536504
2010-07,Oklahoma,6836,5338,12174,3751351
2010-07,Oregon,5966,5944,11910,3831074
2010-07,Pennsylvania,2,42637,42639,12702379
2010-07,Rhode Island,543,375,918,1052567
2010-07,South Carolina,4637,3180,7817,4625364
2010-07,South Dakota,1185,2234,3419,814180
2010-07,Tennessee,12405,8038,20443,6346105
2010-07,Texas,25133,21903,47036,25145561
2010-07,Utah,1906,2291,4197,2763885
2010-07,Vermont,680,800,1480,625741
2010-07,Virginia,12207,8592,20799,8001024
2010-07,Washington,8360,6550,14910,6724540
2010-07,West Virginia,3387,3690,7077,1852994
2010-07,Wisconsin,4188,6434,10622,5686986
2010-07,Wyoming,1023,1294,2317,563626
2010-06,Alabama,8251,6608,14859,4779736
2010-06,Arizona,6144,4484,10628,6392017
2010-06,Arkansas,3409,3134,6543,2915918
2010-06,California,17778,18802,36580,37253956
2010-06,Colorado,9795,8378,18173,5029196
2010-06,Connecticut,3644,2989,6633,3574097
2010-06,Delaware,645,524,1169,897934
2010-06,District of Columbia,19,2,21,601723
2010-06,Florida,24424,11565,35989,18801310
2010-06,Georgia,6093,4332,10425,9687653
2010-06,Idaho,1681,2762,4443,1567582
2010-06,Illinois,7818,6701,14519,12830632
2010-06,Indiana,7950,6307,14257,6483802
2010-06,Iowa,54,1938,1992,3046355
2010-06,Kansas,3638,3443,7081,2853118
2010-06,Kentucky,5223,4634,9857,4339367
2010-06,Louisiana,6170,5091,11261,4533372
2010-06,Maine,1796,2188,3984,1328361
2010-06,Maryland,2898,2663,5561,5773552
2010-06,Massachusetts,2387,1464,3851,6547629
2010-06,Michigan,1312,6790,8102,9883640
2010-06,Minnesota,4255,6687,10942,5303925
2010-06,Mississippi,3282,3117,6399,2967297
2010-06,Missouri,11293,7782,19075,5988927
2010-06,Montana,1979,3358,5337,989415
2010-06,Nebraska,66,1473,1539,1826341
2010-06,Nevada,3399,2595,5994,2700551
2010-06,New Hampshire,2075,1890,3965,1316470
2010-06,New Jersey,2159,1552,3711,8791894
2010-06,New Mexico,3141,2767,5908,2059179
2010-06,New York,5010,8535,13545,19378102
2010-06,North Carolina,226,6657,6883,9535483
2010-06,North Dakota,686,1741,2427,672591
2010-06,Ohio,12808,8904,21712,11536504
2010-06,Oklahoma,6406,4550,10956,3751351
2010-06,Oregon,6223,6549,12772,3831074
2010-06,Pennsylvania,0,42880,42880,12702379
2010-06,Rhode Island,531,433,964,1052567
2010-06,South Carolina,4560,2818,7378,4625364
2010-06,South Dakota,1177,2174,3351,814180
2010-06,Tennessee,11699,6858,18557,6346105
2010-06,Texas,24420,19503,43923,25145561
2010-06,Utah,1910,2565,4475,2763885
2010-06,Vermont,684,716,1400,625741
2010-06,Virginia,9347,6917,16264,8001024
2010-06,Washington,9015,7126,16141,6724540
2010-06,West Virginia,3599,3615,7214,1852994
2010-06,Wisconsin,4254,6869,11123,5686986
2010-06,Wyoming,1156,1439,2595,563626
2010-05,Alabama,8028,6946,14974,4779736
2010-05,Arizona,7261,4744,12005,6392017
2010-05,Arkansas,3353,3225,6578,2915918
2010-05,California,19464,20997,40461,37253956
2010-05,Colorado,10056,8534,18590,5029196
2010-05,Connecticut,3574,2706,6280,3574097
2010-05,Delaware,640,541,1181,897934
2010-05,District of Columbia,24,1,25,601723
2010-05,Florida,25428,11640,37068,18801310
2010-05,Georgia,6477,4553,11030,9687653
2010-05,Idaho,1868,2970,4838,1567582
2010-05,Illinois,8304,7071,15375,12830632
2010-05,Indiana,7761,6257,14018,6483802
2010-05,Iowa,44,1732,1776,3046355
2010-05,Kansas,3782,3634,7416,2853118
2010-05,Kentucky,5486,5056,10542,4339367
2010-05,Louisiana,6047,4511,10558,4533372
2010-05,Maine,1685,2206,3891,1328361
2010-05,Maryland,3220,2724,5944,5773552
2010-05,Massachusetts,2501,1443,3944,6547629
2010-05,Michigan,1552,7455,9007,9883640
2010-05,Minnesota,4672,6238,10910,5303925
2010-05,Mississippi,3540,3054,6594,2967297
2010-05,Missouri,10851,7698,18549,5988927
2010-05,Montana,1977,3426,5403,989415
2010-05,Nebraska,100,1387,1487,1826341
2010-05,Nevada,3919,2883,6802,2700551
2010-05,New Hampshire,2021,1857,3878,1316470
2010-05,New Jersey,2189,1646,3835,8791894
2010-05,New Mexico,3385,2792,6177,2059179
2010-05,New York,4774,8957,13731,19378102
2010-05,North Carolina,206,7040,7246,9535483
2010-05,North Dakota,744,1874,2618,672591
2010-05,Ohio,14214,9410,23624,11536504
2010-05,Oklahoma,7131,4952,12083,3751351
2010-05,Oregon,6477,7125,13602,3831074
2010-05,Pennsylvania,0,41483,41483,12702379
2010-05,Rhode Island,569,393,962,1052567
2010-05,South Carolina,4641,2845,7486,4625364
2010-05,South Dakota,1309,2218,3527,814180
2010-05,Tennessee,11886,6961,18847,6346105
2010-05,Texas,24476,19923,44399,25145561
2010-05,Utah,2192,2682,4874,2763885
2010-05,Vermont,761,826,1587,625741
2010-05,Virginia,15652,11525,27177,8001024
2010-05,Washington,9214,7521,16735,6724540
2010-05,West Virginia,3498,3594,7092,1852994
2010-05,Wisconsin,4439,6821,11260,5686986
2010-05,Wyoming,1193,1687,2880,563626
2010-04,Alabama,8727,8095,16822,4779736
2010-04,Arizona,7787,5097,12884,6392017
2010-04,Arkansas,3865,3833,7698,2915918
2010-04,California,26170,27650,53820,37253956
2010-04,Colorado,10998,9403,20401,5029196
2010-04,Connecticut,3994,3098,7092,3574097
2010-04,Delaware,772,626,1398,897934
2010-04,District of Columbia,29,1,30,601723
2010-04,Florida,26817,12952,39769,18801310
2010-04,Georgia,7215,4897,12112,9687653
2010-04,Idaho,1982,3133,5115,1567582
2010-04,Illinois,8557,8005,16562,12830632
2010-04,Indiana,8149,7473,15622,6483802
2010-04,Iowa,37,2442,2479,3046355
2010-04,Kansas,4268,4182,8450,2853118
2010-04,Kentucky,6274,6352,12626,4339367
2010-04,Louisiana,6363,4992,11355,4533372
2010-04,Maine,2078,2575,4653,1328361
2010-04,Maryland,3671,3136,6807,5773552
2010-04,Massachusetts,2791,1778,4569,6547629
2010-04,Michigan,1636,8860,10496,9883640
2010-04,Minnesota,5514,9001,14515,5303925
2010-04,Mississippi,3883,3256,7139,2967297
2010-04,Missouri,11550,9599,21149,5988927
2010-04,Montana,2172,3824,5996,989415
2010-04,Nebraska,87,1637,1724,1826341
2010-04,Nevada,4284,3138,7422,2700551
2010-04,New Hampshire,2592,2392,4984,1316470
2010-04,New Jersey,2322,1820,4142,8791894
2010-04,New Mexico,3469,3251,6720,2059179
2010-04,New York,5313,11554,16867,19378102
2010-04,North Carolina,203,7514,7717,9535483
2010-04,North Dakota,888,2004,2892,672591
2010-04,Ohio,17333,11342,28675,11536504
2010-04,Oklahoma,8038,6220,14258,3751351
2010-04,Oregon,7445,8065,15510,3831074
2010-04,Pennsylvania,1,49644,49645,12702379
2010-04,Rhode Island,633,483,1116,1052567
2010-04,South Carolina,5313,3336,8649,4625364
2010-04,South Dakota,1396,2785,4181,814180
2010-04,Tennessee,12533,8066,20599,6346105
2010-04,Texas,24481,21343,45824,25145561
2010-04,Utah,2379,2996,5375,2763885
2010-04,Vermont,830,1181,2011,625741
2010-04,Virginia,25259,18158,43417,8001024
2010-04,Washington,10384,7986,18370,6724540
2010-04,West Virginia,3927,4534,8461,1852994
2010-04,Wisconsin,5414,10701,16115,5686986
2010-04,Wyoming,1295,1700,2995,563626
2010-03,Alabama,11242,10951,22193,4779736
2010-03,Arizona,7463,5783,13246,6392017
2010-03,Arkansas,5632,5082,10714,2915918
2010-03,California,23487,25449,48936,37253956
2010-03,Colorado,12245,11297,23542,5029196
2010-03,Connecticut,4842,3959,8801,3574097
2010-03,Delaware,1024,790,1814,897934
2010-03,District of Columbia,38,1,39,601723
2010-03,Florida,32241,16265,48506,18801310
2010-03,Georgia,10166,7367,17533,9687653
2010-03,Idaho,2240,3694,5934,1567582
2010-03,Illinois,11425,11398,22823,12830632
2010-03,Indiana,12071,10378,22449,6483802
2010-03,Iowa,73,4220,4293,3046355
2010-03,Kansas,6180,5547,11727,2853118
2010-03,Kentucky,8521,8143,16664,4339367
2010-03,Louisiana,8470,7264,15734,4533372
2010-03,Maine,2495,3053,5548,1328361
2010-03,Maryland,4343,3889,8232,5773552
2010-03,Massachusetts,3401,2105,5506,6547629
2010-03,Michigan,2199,11678,13877,9883640
2010-03,Minnesota,6581,10129,16710,5303925
2010-03,Mississippi,5106,5257,10363,2967297
2010-03,Missouri,15617,12253,27870,5988927
2010-03,Montana,2383,4352,6735,989415
2010-03,Nebraska,62,2201,2263,1826341
2010-03,Nevada,4820,3390,8210,2700551
2010-03,New Hampshire,2791,2354,5145,1316470
2010-03,New Jersey,2707,2159,4866,8791894
2010-03,New Mexico,4443,4068,8511,2059179
2010-03,New York,6093,12810,18903,19378102
2010-03,North Carolina,281,9850,10131,9535483
2010-03,North Dakota,1108,2342,3450,672591
2010-03,Ohio,21508,14073,35581,11536504
2010-03,Oklahoma,8887,7274,16161,3751351
2010-03,Oregon,8050,9568,17618,3831074
2010-03,Pennsylvania,1,65524,65525,12702379
2010-03,Rhode Island,803,636,1439,1052567
2010-03,South Carolina,7391,4645,12036,4625364
2010-03,South Dakota,1715,3283,4998,814180
2010-03,Tennessee,15605,10938,26543,6346105
2010-03,Texas,31512,25440,56952,25145561
2010-03,Utah,2762,3486,6248,2763885
2010-03,Vermont,1081,1495,2576,625741
2010-03,Virginia,18718,11119,29837,8001024
2010-03,Washington,11607,9443,21050,6724540
2010-03,West Virginia,5216,5857,11073,1852994
2010-03,Wisconsin,6911,14209,21120,5686986
2010-03,Wyoming,1473,1934,3407,563626
2010-02,Alabama,13055,11229,24284,4779736
2010-02,Arizona,8329,6312,14641,6392017
2010-02,Arkansas,6346,6412,12758,2915918
2010-02,California,19706,21016,40722,37253956
2010-02,Colorado,11557,10569,22126,5029196
2010-02,Connecticut,4327,3223,7550,3574097
2010-02,Delaware,726,627,1353,897934
2010-02,District of Columbia,28,1,29,601723
2010-02,Florida,30890,16415,47305,18801310
2010-02,Georgia,12525,8331,20856,9687653
2010-02,Idaho,2150,3451,5601,1567582
2010-02,Illinois,9998,10190,20188,12830632
2010-02,Indiana,11285,9441,20726,6483802
2010-02,Iowa,61,3259,3320,3046355
2010-02,Kansas,5920,5742,11662,2853118
2010-02,Kentucky,9886,9557,19443,4339367
2010-02,Louisiana,9146,7329,16475,4533372
2010-02,Maine,2053,2462,4515,1328361
2010-02,Maryland,3322,3343,6665,5773552
2010-02,Massachusetts,2858,1628,4486,6547629
2010-02,Michigan,2017,10098,12115,9883640
2010-02,Minnesota,4957,7188,12145,5303925
2010-02,Mississippi,6188,5762,11950,2967297
2010-02,Missouri,16080,12779,28859,5988927
2010-02,Montana,2132,3558,5690,989415
2010-02,Nebraska,23,1864,1887,1826341
2010-02,Nevada,4013,3119,7132,2700551
2010-02,New Hampshire,2452,2150,4602,1316470
2010-02,New Jersey,1915,1675,3590,8791894
2010-02,New Mexico,4232,3940,8172,2059179
2010-02,New York,4702,10776,15478,19378102
2010-02,North Carolina,325,11629,11954,9535483
2010-02,North Dakota,868,1943,2811,672591
2010-02,Ohio,18528,12089,30617,11536504
2010-02,Oklahoma,10593,8169,18762,3751351
2010-02,Oregon,7376,8846,16222,3831074
2010-02,Pennsylvania,0,47152,47152,12702379
2010-02,Rhode Island,717,499,1216,1052567
2010-02,South Carolina,9261,5147,14408,4625364
2010-02,South Dakota,1518,2978,4496,814180
2010-02,Tennessee,18309,12832,31141,6346105
2010-02,Texas,36493,27823,64316,25145561
2010-02,Utah,2861,3624,6485,2763885
2010-02,Vermont,989,1194,2183,625741
2010-02,Virginia,14130,11132,25262,8001024
2010-02,Washington,11162,9260,20422,6724540
2010-02,West Virginia,4859,5705,10564,1852994
2010-02,Wisconsin,5615,9841,15456,5686986
2010-02,Wyoming,1330,1680,3010,563626
2010-01,Alabama,9404,10081,19485,4779736
2010-01,Arizona,6479,5178,11657,6392017
2010-01,Arkansas,3783,5039,8822,2915918
2010-01,California,18280,20059,38339,37253956
2010-01,Colorado,10471,10141,20612,5029196
2010-01,Connecticut,4147,3316,7463,3574097
2010-01,Delaware,785,792,1577,897934
2010-01,District of Columbia,20,1,21,601723
2010-01,Florida,27038,15924,42962,18801310
2010-01,Georgia,8603,7074,15677,9687653
2010-01,Idaho,1731,2693,4424,1567582
2010-01,Illinois,8799,9303,18102,12830632
2010-01,Indiana,9948,8614,18562,6483802
2010-01,Iowa,36,2748,2784,3046355
2010-01,Kansas,5077,5286,10363,2853118
2010-01,Kentucky,7133,7283,14416,4339367
2010-01,Louisiana,6607,7589,14196,4533372
2010-01,Maine,1590,2036,3626,1328361
2010-01,Maryland,3474,3364,6838,5773552
2010-01,Massachusetts,3060,1890,4950,6547629
2010-01,Michigan,1901,8441,10342,9883640
2010-01,Minnesota,4478,6191,10669,5303925
2010-01,Mississippi,3800,5394,9194,2967297
2010-01,Missouri,12126,10374,22500,5988927
2010-01,Montana,1596,3017,4613,989415
2010-01,Nebraska,12,1800,1812,1826341
2010-01,Nevada,3511,2806,6317,2700551
2010-01,New Hampshire,2346,1998,4344,1316470
2010-01,New Jersey,1958,2011,3969,8791894
2010-01,New Mexico,2994,3356,6350,2059179
2010-01,New York,4521,10202,14723,19378102
2010-01,North Carolina,230,9770,10000,9535483
2010-01,North Dakota,684,1895,2579,672591
2010-01,Ohio,16178,11272,27450,11536504
2010-01,Oklahoma,7104,6793,13897,3751351
2010-01,Oregon,5995,6714,12709,3831074
2010-01,Pennsylvania,0,47194,47194,12702379
2010-01,Rhode Island,648,504,1152,1052567
2010-01,South Carolina,6079,4278,10357,4625364
2010-01,South Dakota,1194,2423,3617,814180
2010-01,Tennessee,12900,9816,22716,6346105
2010-01,Texas,27645,26553,54198,25145561
2010-01,Utah,2356,2824,5180,2763885
2010-01,Vermont,647,801,1448,625741
2010-01,Virginia,11513,10323,21836,8001024
2010-01,Washington,9348,8287,17635,6724540
2010-01,West Virginia,3735,4860,8595,1852994
2010-01,Wisconsin,4382,7950,12332,5686986
2010-01,Wyoming,1036,1413,2449,563626
2009-12,Alabama,13285,23760,37045,4779736
2009-12,Arizona,7360,8454,15814,6392017
2009-12,Arkansas,5310,12090,17400,2915918
2009-12,California,19496,27200,46696,37253956
2009-12,Colorado,11307,14781,26088,5029196
2009-12,Connecticut,4091,4246,8337,3574097
2009-12,Delaware,871,1329,2200,897934
2009-12,District of Columbia,19,0,19,601723
2009-12,Florida,29581,24460,54041,18801310
2009-12,Georgia,10771,17354,28125,9687653
2009-12,Idaho,2153,5188,7341,1567582
2009-12,Illinois,9316,13652,22968,12830632
2009-12,Indiana,9904,14739,24643,6483802
2009-12,Iowa,42,5570,5612,3046355
2009-12,Kansas,5473,9638,15111,2853118
2009-12,Kentucky,9768,16164,25932,4339367
2009-12,Louisiana,9719,20417,30136,4533372
2009-12,Maine,1949,3627,5576,1328361
2009-12,Maryland,3095,5433,8528,5773552
2009-12,Massachusetts,2476,2014,4490,6547629
2009-12,Michigan,1867,14945,16812,9883640
2009-12,Minnesota,4912,10262,15174,5303925
2009-12,Mississippi,5272,16234,21506,2967297
2009-12,Missouri,14525,19444,33969,5988927
2009-12,Montana,2083,5309,7392,989415
2009-12,Nebraska,21,3960,3981,1826341
2009-12,Nevada,4493,4516,9009,2700551
2009-12,New Hampshire,2421,2572,4993,1316470
2009-12,New Jersey,2139,2754,4893,8791894
2009-12,New Mexico,3806,5524,9330,2059179
2009-12,New York,4652,15879,20531,19378102
2009-12,North Carolina,239,21565,21804,9535483
2009-12,North Dakota,852,2860,3712,672591
2009-12,Ohio,17880,20595,38475,11536504
2009-12,Oklahoma,9249,13253,22502,3751351
2009-12,Oregon,6912,11402,18314,3831074
2009-12,Pennsylvania,0,56138,56138,12702379
2009-12,Rhode Island,645,636,1281,1052567
2009-12,South Carolina,7431,9987,17418,4625364
2009-12,South Dakota,1367,4622,5989,814180
2009-12,Tennessee,16886,20554,37440,6346105
2009-12,Texas,38003,55742,93745,25145561
2009-12,Utah,3123,6483,9606,2763885
2009-12,Vermont,769,1249,2018,625741
2009-12,Virginia,11911,17572,29483,8001024
2009-12,Washington,11211,12797,24008,6724540
2009-12,West Virginia,5102,9994,15096,1852994
2009-12,Wisconsin,5164,11178,16342,5686986
2009-12,Wyoming,1366,2548,3914,563626
2009-11,Alabama,8846,17054,25900,4779736
2009-11,Arizona,4950,5721,10671,6392017
2009-11,Arkansas,3487,9651,13138,2915918
2009-11,California,16571,22677,39248,37253956
2009-11,Colorado,9422,11977,21399,5029196
2009-11,Connecticut,3409,3866,7275,3574097
2009-11,Delaware,656,1227,1883,897934
2009-11,District of Columbia,29,0,29,601723
2009-11,Florida,25427,17590,43017,18801310
2009-11,Georgia,6802,10988,17790,9687653
2009-11,Idaho,1540,3649,5189,1567582
2009-11,Illinois,7925,12399,20324,12830632
2009-11,Indiana,7883,14084,21967,6483802
2009-11,Iowa,27,5416,5443,3046355
2009-11,Kansas,4396,8394,12790,2853118
2009-11,Kentucky,6521,12119,18640,4339367
2009-11,Louisiana,6232,13866,20098,4533372
2009-11,Maine,1552,3607,5159,1328361
2009-11,Maryland,3567,5674,9241,5773552
2009-11,Massachusetts,2420,2251,4671,6547629
2009-11,Michigan,1814,16893,18707,9883640
2009-11,Minnesota,3966,10999,14965,5303925
2009-11,Mississippi,3428,11069,14497,2967297
2009-11,Missouri,10663,16145,26808,5988927
2009-11,Montana,1521,3913,5434,989415
2009-11,Nebraska,16,3611,3627,1826341
2009-11,Nevada,3411,3284,6695,2700551
2009-11,New Hampshire,2234,2729,4963,1316470
2009-11,New Jersey,1999,2644,4643,8791894
2009-11,New Mexico,2699,3571,6270,2059179
2009-11,New York,4162,16442,20604,19378102
2009-11,North Carolina,214,15387,15601,9535483
2009-11,North Dakota,737,2881,3618,672591
2009-11,Ohio,15223,20759,35982,11536504
2009-11,Oklahoma,7205,10286,17491,3751351
2009-11,Oregon,5618,8861,14479,3831074
2009-11,Pennsylvania,0,59769,59769,12702379
2009-11,Rhode Island,554,534,1088,1052567
2009-11,South Carolina,7783,8398,16181,4625364
2009-11,South Dakota,1012,4323,5335,814180
2009-11,Tennessee,12301,15026,27327,6346105
2009-11,Texas,27116,36125,63241,25145561
2009-11,Utah,2402,4379,6781,2763885
2009-11,Vermont,529,1500,2029,625741
2009-11,Virginia,11099,15971,27070,8001024
2009-11,Washington,8101,9112,17213,6724540
2009-11,West Virginia,3522,9722,13244,1852994
2009-11,Wisconsin,4708,14139,18847,5686986
2009-11,Wyoming,1023,1758,2781,563626
2009-10,Alabama,9051,13174,22225,4779736
2009-10,Arizona,5272,5127,10399,6392017
2009-10,Arkansas,3362,7981,11343,2915918
2009-10,California,17537,19713,37250,37253956
2009-10,Colorado,8995,11262,20257,5029196
2009-10,Connecticut,3830,3937,7767,3574097
2009-10,Delaware,715,1006,1721,897934
2009-10,District of Columbia,28,0,28,601723
2009-10,Florida,25740,15529,41269,18801310
2009-10,Georgia,7054,10157,17211,9687653
2009-10,Idaho,1559,3962,5521,1567582
2009-10,Illinois,8321,11369,19690,12830632
2009-10,Indiana,8784,11917,20701,6483802
2009-10,Iowa,33,4700,4733,3046355
2009-10,Kansas,4912,7135,12047,2853118
2009-10,Kentucky,6802,11016,17818,4339367
2009-10,Louisiana,6313,13425,19738,4533372
2009-10,Maine,1905,5557,7462,1328361
2009-10,Maryland,3209,4739,7948,5773552
2009-10,Massachusetts,2700,2233,4933,6547629
2009-10,Michigan,1847,14413,16260,9883640
2009-10,Minnesota,4546,16459,21005,5303925
2009-10,Mississippi,3643,7635,11278,2967297
2009-10,Missouri,12308,16487,28795,5988927
2009-10,Montana,1733,5721,7454,989415
2009-10,Nebraska,13,3290,3303,1826341
2009-10,Nevada,3708,3096,6804,2700551
2009-10,New Hampshire,2724,3388,6112,1316470
2009-10,New Jersey,2393,2497,4890,8791894
2009-10,New Mexico,3191,3570,6761,2059179
2009-10,New York,4851,17047,21898,19378102
2009-10,North Carolina,212,13089,13301,9535483
2009-10,North Dakota,729,4300,5029,672591
2009-10,Ohio,15130,15489,30619,11536504
2009-10,Oklahoma,6218,8201,14419,3751351
2009-10,Oregon,5616,8543,14159,3831074
2009-10,Pennsylvania,0,55853,55853,12702379
2009-10,Rhode Island,654,584,1238,1052567
2009-10,South Carolina,4957,5714,10671,4625364
2009-10,South Dakota,1127,5923,7050,814180
2009-10,Tennessee,12770,12309,25079,6346105
2009-10,Texas,24638,32633,57271,25145561
2009-10,Utah,2056,3591,5647,2763885
2009-10,Vermont,692,1687,2379,625741
2009-10,Virginia,12430,14753,27183,8001024
2009-10,Washington,8594,9790,18384,6724540
2009-10,West Virginia,3582,8264,11846,1852994
2009-10,Wisconsin,4807,15777,20584,5686986
2009-10,Wyoming,915,1764,2679,563626
2009-09,Alabama,7789,11911,19700,4779736
2009-09,Arizona,5369,5353,10722,6392017
2009-09,Arkansas,3447,6513,9960,2915918
2009-09,California,15805,19228,35033,37253956
2009-09,Colorado,9181,9886,19067,5029196
2009-09,Connecticut,3276,3077,6353,3574097
2009-09,Delaware,678,798,1476,897934
2009-09,District of Columbia,23,0,23,601723
2009-09,Florida,23346,13521,36867,18801310
2009-09,Georgia,6389,7383,13772,9687653
2009-09,Idaho,1500,3685,5185,1567582
2009-09,Illinois,6722,9425,16147,12830632
2009-09,Indiana,6860,8705,15565,6483802
2009-09,Iowa,29,3416,3445,3046355
2009-09,Kansas,3726,5308,9034,2853118
2009-09,Kentucky,5913,8115,14028,4339367
2009-09,Louisiana,8739,14274,23013,4533372
2009-09,Maine,1763,3787,5550,1328361
2009-09,Maryland,3241,3717,6958,5773552
2009-09,Massachusetts,2181,1784,3965,6547629
2009-09,Michigan,1690,12250,13940,9883640
2009-09,Minnesota,4113,13734,17847,5303925
2009-09,Mississippi,3295,6237,9532,2967297
2009-09,Missouri,10959,11621,22580,5988927
2009-09,Montana,1808,4398,6206,989415
2009-09,Nebraska,8,2476,2484,1826341
2009-09,Nevada,2868,2614,5482,2700551
2009-09,New Hampshire,2078,2554,4632,1316470
2009-09,New Jersey,2182,1819,4001,8791894
2009-09,New Mexico,2873,3316,6189,2059179
2009-09,New York,4246,13698,17944,19378102
2009-09,North Carolina,183,10168,10351,9535483
2009-09,North Dakota,643,2787,3430,672591
2009-09,Ohio,12947,12103,25050,11536504
2009-09,Oklahoma,5729,6593,12322,3751351
2009-09,Oregon,5443,8675,14118,3831074
2009-09,Pennsylvania,0,50144,50144,12702379
2009-09,Rhode Island,444,551,995,1052567
2009-09,South Carolina,4909,5215,10124,4625364
2009-09,South Dakota,1115,4207,5322,814180
2009-09,Tennessee,11365,9855,21220,6346105
2009-09,Texas,21498,33233,54731,25145561
2009-09,Utah,2013,3448,5461,2763885
2009-09,Vermont,634,1353,1987,625741
2009-09,Virginia,9887,11211,21098,8001024
2009-09,Washington,7347,8666,16013,6724540
2009-09,West Virginia,3374,5763,9137,1852994
2009-09,Wisconsin,4682,12645,17327,5686986
2009-09,Wyoming,1015,1813,2828,563626
2009-08,Alabama,8680,11371,20051,4779736
2009-08,Arizona,5539,5189,10728,6392017
2009-08,Arkansas,3682,4827,8509,2915918
2009-08,California,17376,21212,38588,37253956
2009-08,Colorado,9391,9936,19327,5029196
2009-08,Connecticut,3486,2936,6422,3574097
2009-08,Delaware,699,808,1507,897934
2009-08,District of Columbia,30,0,30,601723
2009-08,Florida,24043,13398,37441,18801310
2009-08,Georgia,7279,6932,14211,9687653
2009-08,Idaho,1510,3112,4622,1567582
2009-08,Illinois,6978,9265,16243,12830632
2009-08,Indiana,7900,8544,16444,6483802
2009-08,Iowa,32,2608,2640,3046355
2009-08,Kansas,4333,5339,9672,2853118
2009-08,Kentucky,5978,7073,13051,4339367
2009-08,Louisiana,6833,9223,16056,4533372
2009-08,Maine,1544,2572,4116,1328361
2009-08,Maryland,2939,3317,6256,5773552
2009-08,Massachusetts,1978,1426,3404,6547629
2009-08,Michigan,1905,9943,11848,9883640
2009-08,Minnesota,4483,10322,14805,5303925
2009-08,Mississippi,3621,5482,9103,2967297
2009-08,Missouri,11415,11302,22717,5988927
2009-08,Montana,1999,4069,6068,989415
2009-08,Nebraska,7,2105,2112,1826341
2009-08,Nevada,3342,2822,6164,2700551
2009-08,New Hampshire,1920,2184,4104,1316470
2009-08,New Jersey,2368,1724,4092,8791894
2009-08,New Mexico,3127,3238,6365,2059179
2009-08,New York,3989,9924,13913,19378102
2009-08,North Carolina,193,9260,9453,9535483
2009-08,North Dakota,634,2335,2969,672591
2009-08,Ohio,12895,11300,24195,11536504
2009-08,Oklahoma,6981,6726,13707,3751351
2009-08,Oregon,5231,6588,11819,3831074
2009-08,Pennsylvania,0,44637,44637,12702379
2009-08,Rhode Island,480,402,882,1052567
2009-08,South Carolina,5034,4635,9669,4625364
2009-08,South Dakota,1054,3326,4380,814180
2009-08,Tennessee,11855,9296,21151,6346105
2009-08,Texas,24624,30487,55111,25145561
2009-08,Utah,1856,2941,4797,2763885
2009-08,Vermont,671,927,1598,625741
2009-08,Virginia,10372,10198,20570,8001024
2009-08,Washington,7816,8045,15861,6724540
2009-08,West Virginia,3509,4396,7905,1852994
2009-08,Wisconsin,4500,9966,14466,5686986
2009-08,Wyoming,1106,1746,2852,563626
2009-07,Alabama,8101,8815,16916,4779736
2009-07,Arizona,5554,4386,9940,6392017
2009-07,Arkansas,3540,3779,7319,2915918
2009-07,California,18555,17211,35766,37253956
2009-07,Colorado,8577,8285,16862,5029196
2009-07,Connecticut,3273,2502,5775,3574097
2009-07,Delaware,671,534,1205,897934
2009-07,District of Columbia,24,0,24,601723
2009-07,Florida,23694,12349,36043,18801310
2009-07,Georgia,6383,4781,11164,9687653
2009-07,Idaho,1426,2361,3787,1567582
2009-07,Illinois,6742,6733,13475,12830632
2009-07,Indiana,6953,6249,13202,6483802
2009-07,Iowa,29,1747,1776,3046355
2009-07,Kansas,3648,3510,7158,2853118
2009-07,Kentucky,6320,5795,12115,4339367
2009-07,Louisiana,6784,6226,13010,4533372
2009-07,Maine,1405,2145,3550,1328361
2009-07,Maryland,3445,2749,6194,5773552
2009-07,Massachusetts,2181,1422,3603,6547629
2009-07,Michigan,1846,7062,8908,9883640
2009-07,Minnesota,3775,6199,9974,5303925
2009-07,Mississippi,3519,3617,7136,2967297
2009-07,Missouri,10460,8303,18763,5988927
2009-07,Montana,1846,3103,4949,989415
2009-07,Nebraska,11,1399,1410,1826341
2009-07,Nevada,3038,2282,5320,2700551
2009-07,New Hampshire,1958,1891,3849,1316470
2009-07,New Jersey,2587,1748,4335,8791894
2009-07,New Mexico,2801,2737,5538,2059179
2009-07,New York,4082,8313,12395,19378102
2009-07,North Carolina,176,7255,7431,9535483
2009-07,North Dakota,659,1702,2361,672591
2009-07,Ohio,12794,10179,22973,11536504
2009-07,Oklahoma,6465,5066,11531,3751351
2009-07,Oregon,5009,5631,10640,3831074
2009-07,Pennsylvania,0,42530,42530,12702379
2009-07,Rhode Island,447,399,846,1052567
2009-07,South Carolina,5605,3270,8875,4625364
2009-07,South Dakota,1038,2241,3279,814180
2009-07,Tennessee,11526,7335,18861,6346105
2009-07,Texas,23326,20778,44104,25145561
2009-07,Utah,1712,2289,4001,2763885
2009-07,Vermont,623,780,1403,625741
2009-07,Virginia,11029,9065,20094,8001024
2009-07,Washington,7218,6415,13633,6724540
2009-07,West Virginia,3262,3751,7013,1852994
2009-07,Wisconsin,4128,6078,10206,5686986
2009-07,Wyoming,992,1355,2347,563626
2009-06,Alabama,7909,7335,15244,4779736
2009-06,Arizona,5878,4908,10786,6392017
2009-06,Arkansas,3636,3427,7063,2915918
2009-06,California,20060,18949,39009,37253956
2009-06,Colorado,8963,8582,17545,5029196
2009-06,Connecticut,3588,2709,6297,3574097
2009-06,Delaware,668,599,1267,897934
2009-06,District of Columbia,27,1,28,601723
2009-06,Florida,23275,12448,35723,18801310
2009-06,Georgia,6330,4656,10986,9687653
2009-06,Idaho,1508,2626,4134,1567582
2009-06,Illinois,6907,7155,14062,12830632
2009-06,Indiana,6842,6285,13127,6483802
2009-06,Iowa,38,1771,1809,3046355
2009-06,Kansas,3713,3404,7117,2853118
2009-06,Kentucky,5800,5457,11257,4339367
2009-06,Louisiana,6370,5462,11832,4533372
2009-06,Maine,1443,2052,3495,1328361
2009-06,Maryland,3552,2772,6324,5773552
2009-06,Massachusetts,2256,1502,3758,6547629
2009-06,Michigan,1865,7054,8919,9883640
2009-06,Minnesota,4287,6008,10295,5303925
2009-06,Mississippi,3116,3043,6159,2967297
2009-06,Missouri,10835,7823,18658,5988927
2009-06,Montana,1873,3699,5572,989415
2009-06,Nebraska,6,1354,1360,1826341
2009-06,Nevada,3372,2687,6059,2700551
2009-06,New Hampshire,1897,1902,3799,1316470
2009-06,New Jersey,2815,1827,4642,8791894
2009-06,New Mexico,3028,3015,6043,2059179
2009-06,New York,4358,8854,13212,19378102
2009-06,North Carolina,179,7067,7246,9535483
2009-06,North Dakota,697,1700,2397,672591
2009-06,Ohio,12529,10182,22711,11536504
2009-06,Oklahoma,6100,4876,10976,3751351
2009-06,Oregon,5518,6207,11725,3831074
2009-06,Pennsylvania,1,43184,43185,12702379
2009-06,Rhode Island,533,443,976,1052567
2009-06,South Carolina,4802,2857,7659,4625364
2009-06,South Dakota,1064,2369,3433,814180
2009-06,Tennessee,10816,7062,17878,6346105
2009-06,Texas,23978,21010,44988,25145561
2009-06,Utah,2271,2773,5044,2763885
2009-06,Vermont,619,683,1302,625741
2009-06,Virginia,9000,7836,16836,8001024
2009-06,Washington,7632,7044,14676,6724540
2009-06,West Virginia,3231,3760,6991,1852994
2009-06,Wisconsin,4239,6027,10266,5686986
2009-06,Wyoming,1170,1739,2909,563626
2009-05,Alabama,8829,7878,16707,4779736
2009-05,Arizona,7009,5248,12257,6392017
2009-05,Arkansas,4031,3860,7891,2915918
2009-05,California,21720,19881,41601,37253956
2009-05,Colorado,9610,9227,18837,5029196
2009-05,Connecticut,3635,3014,6649,3574097
2009-05,Delaware,783,594,1377,897934
2009-05,District of Columbia,29,0,29,601723
2009-05,Florida,24856,13363,38219,18801310
2009-05,Georgia,7119,5205,12324,9687653
2009-05,Idaho,1741,2880,4621,1567582
2009-05,Illinois,7541,7609,15150,12830632
2009-05,Indiana,8333,6790,15123,6483802
2009-05,Iowa,32,1948,1980,3046355
2009-05,Kansas,4307,3791,8098,2853118
2009-05,Kentucky,6539,6080,12619,4339367
2009-05,Louisiana,7143,5617,12760,4533372
2009-05,Maine,1511,2124,3635,1328361
2009-05,Maryland,3379,2803,6182,5773552
2009-05,Massachusetts,2374,1611,3985,6547629
2009-05,Michigan,2111,8051,10162,9883640
2009-05,Minnesota,4924,6387,11311,5303925
2009-05,Mississippi,3774,3415,7189,2967297
2009-05,Missouri,11593,8533,20126,5988927
2009-05,Montana,2204,3943,6147,989415
2009-05,Nebraska,11,1383,1394,1826341
2009-05,Nevada,3797,2834,6631,2700551
2009-05,New Hampshire,2160,1962,4122,1316470
2009-05,New Jersey,2763,1721,4484,8791894
2009-05,New Mexico,3168,3093,6261,2059179
2009-05,New York,4331,9477,13808,19378102
2009-05,North Carolina,202,7918,8120,9535483
2009-05,North Dakota,786,1924,2710,672591
2009-05,Ohio,14248,10629,24877,11536504
2009-05,Oklahoma,7570,5803,13373,3751351
2009-05,Oregon,5738,7930,13668,3831074
2009-05,Pennsylvania,0,45521,45521,12702379
2009-05,Rhode Island,583,438,1021,1052567
2009-05,South Carolina,5536,3346,8882,4625364
2009-05,South Dakota,1150,2289,3439,814180
2009-05,Tennessee,12170,7862,20032,6346105
2009-05,Texas,28423,23739,52162,25145561
2009-05,Utah,2470,3024,5494,2763885
2009-05,Vermont,708,823,1531,625741
2009-05,Virginia,10908,8602,19510,8001024
2009-05,Washington,8910,8677,17587,6724540
2009-05,West Virginia,3579,3950,7529,1852994
2009-05,Wisconsin,4679,6934,11613,5686986
2009-05,Wyoming,1350,1811,3161,563626
2009-04,Alabama,9679,8461,18140,4779736
2009-04,Arizona,8879,6398,15277,6392017
2009-04,Arkansas,5244,4822,10066,2915918
2009-04,California,24726,22698,47424,37253956
2009-04,Colorado,12388,11862,24250,5029196
2009-04,Connecticut,4332,3404,7736,3574097
2009-04,Delaware,934,749,1683,897934
2009-04,District of Columbia,34,0,34,601723
2009-04,Florida,29375,16392,45767,18801310
2009-04,Georgia,8918,6194,15112,9687653
2009-04,Idaho,2423,4005,6428,1567582
2009-04,Illinois,9711,9588,19299,12830632
2009-04,Indiana,9930,9257,19187,6483802
2009-04,Iowa,43,3095,3138,3046355
2009-04,Kansas,5445,5135,10580,2853118
2009-04,Kentucky,7815,8338,16153,4339367
2009-04,Louisiana,8819,6601,15420,4533372
2009-04,Maine,2138,2683,4821,1328361
2009-04,Maryland,4728,3590,8318,5773552
2009-04,Massachusetts,2868,1973,4841,6547629
2009-04,Michigan,2654,10888,13542,9883640
2009-04,Minnesota,7629,11122,18751,5303925
2009-04,Mississippi,4591,4297,8888,2967297
2009-04,Missouri,14959,11949,26908,5988927
2009-04,Montana,2467,4290,6757,989415
2009-04,Nebraska,14,1887,1901,1826341
2009-04,Nevada,4693,4154,8847,2700551
2009-04,New Hampshire,2723,2710,5433,1316470
2009-04,New Jersey,3059,1919,4978,8791894
2009-04,New Mexico,3551,3862,7413,2059179
2009-04,New York,5407,12724,18131,19378102
2009-04,North Carolina,200,9250,9450,9535483
2009-04,North Dakota,1078,2285,3363,672591
2009-04,Ohio,18925,13879,32804,11536504
2009-04,Oklahoma,9943,8107,18050,3751351
2009-04,Oregon,7488,8956,16444,3831074
2009-04,Pennsylvania,2,59477,59479,12702379
2009-04,Rhode Island,734,579,1313,1052567
2009-04,South Carolina,7036,3894,10930,4625364
2009-04,South Dakota,1837,3342,5179,814180
2009-04,Tennessee,14262,9547,23809,6346105
2009-04,Texas,34759,27916,62675,25145561
2009-04,Utah,3479,3783,7262,2763885
2009-04,Vermont,820,1254,2074,625741
2009-04,Virginia,14750,10959,25709,8001024
2009-04,Washington,10692,9498,20190,6724540
2009-04,West Virginia,4707,5147,9854,1852994
2009-04,Wisconsin,7041,12200,19241,5686986
2009-04,Wyoming,1525,2107,3632,563626
2009-03,Alabama,12222,12307,24529,4779736
2009-03,Arizona,9136,6920,16056,6392017
2009-03,Arkansas,6679,6223,12902,2915918
2009-03,California,25647,25791,51438,37253956
2009-03,Colorado,13812,13380,27192,5029196
2009-03,Connecticut,4862,4072,8934,3574097
2009-03,Delaware,1016,961,1977,897934
2009-03,District of Columbia,40,0,40,601723
2009-03,Florida,33030,19076,52106,18801310
2009-03,Georgia,12007,8976,20983,9687653
2009-03,Idaho,2885,4852,7737,1567582
2009-03,Illinois,11271,12079,23350,12830632
2009-03,Indiana,13079,11272,24351,6483802
2009-03,Iowa,62,4418,4480,3046355
2009-03,Kansas,6893,6182,13075,2853118
2009-03,Kentucky,9861,9571,19432,4339367
2009-03,Louisiana,10781,8223,19004,4533372
2009-03,Maine,2445,2998,5443,1328361
2009-03,Maryland,5564,4027,9591,5773552
2009-03,Massachusetts,3372,2355,5727,6547629
2009-03,Michigan,3089,13122,16211,9883640
2009-03,Minnesota,7683,11212,18895,5303925
2009-03,Mississippi,5391,5577,10968,2967297
2009-03,Missouri,18212,14060,32272,5988927
2009-03,Montana,2914,4365,7279,989415
2009-03,Nebraska,10,2343,2353,1826341
2009-03,Nevada,5254,4424,9678,2700551
2009-03,New Hampshire,2819,2824,5643,1316470
2009-03,New Jersey,3011,2150,5161,8791894
2009-03,New Mexico,4384,4491,8875,2059179
2009-03,New York,5447,13506,18953,19378102
2009-03,North Carolina,265,12004,12269,9535483
2009-03,North Dakota,1033,2134,3167,672591
2009-03,Ohio,22991,15972,38963,11536504
2009-03,Oklahoma,10104,8493,18597,3751351
2009-03,Oregon,9003,11134,20137,3831074
2009-03,Pennsylvania,4,69206,69210,12702379
2009-03,Rhode Island,781,621,1402,1052567
2009-03,South Carolina,8144,5443,13587,4625364
2009-03,South Dakota,1944,3512,5456,814180
2009-03,Tennessee,17333,12230,29563,6346105
2009-03,Texas,39711,30837,70548,25145561
2009-03,Utah,3825,4437,8262,2763885
2009-03,Vermont,1057,1324,2381,625741
2009-03,Virginia,15879,12574,28453,8001024
2009-03,Washington,12231,11231,23462,6724540
2009-03,West Virginia,5468,5967,11435,1852994
2009-03,Wisconsin,8549,15092,23641,5686986
2009-03,Wyoming,1900,2447,4347,563626
2009-02,Alabama,13196,12349,25545,4779736
2009-02,Arizona,9097,6842,15939,6392017
2009-02,Arkansas,7254,6875,14129,2915918
2009-02,California,21699,20438,42137,37253956
2009-02,Colorado,12676,11917,24593,5029196
2009-02,Connecticut,4552,3581,8133,3574097
2009-02,Delaware,1050,793,1843,897934
2009-02,District of Columbia,40,0,40,601723
2009-02,Florida,31718,18854,50572,18801310
2009-02,Georgia,14544,9694,24238,9687653
2009-02,Idaho,2716,3887,6603,1567582
2009-02,Illinois,9434,9809,19243,12830632
2009-02,Indiana,12371,10320,22691,6483802
2009-02,Iowa,39,3526,3565,3046355
2009-02,Kansas,6095,5784,11879,2853118
2009-02,Kentucky,10137,9677,19814,4339367
2009-02,Louisiana,10891,8192,19083,4533372
2009-02,Maine,1965,2301,4266,1328361
2009-02,Maryland,4732,4308,9040,5773552
2009-02,Massachusetts,2790,1723,4513,6547629
2009-02,Michigan,2616,10944,13560,9883640
2009-02,Minnesota,5961,7939,13900,5303925
2009-02,Mississippi,6683,6465,13148,2967297
2009-02,Missouri,17405,13693,31098,5988927
2009-02,Montana,2427,3740,6167,989415
2009-02,Nebraska,10,2141,2151,1826341
2009-02,Nevada,4777,3495,8272,2700551
2009-02,New Hampshire,2567,2285,4852,1316470
2009-02,New Jersey,2444,1799,4243,8791894
2009-02,New Mexico,4453,4332,8785,2059179
2009-02,New York,4576,11605,16181,19378102
2009-02,North Carolina,317,13072,13389,9535483
2009-02,North Dakota,1043,2042,3085,672591
2009-02,Ohio,21117,14200,35317,11536504
2009-02,Oklahoma,11205,8972,20177,3751351
2009-02,Oregon,7981,9473,17454,3831074
2009-02,Pennsylvania,0,57150,57150,12702379
2009-02,Rhode Island,671,551,1222,1052567
2009-02,South Carolina,9482,5907,15389,4625364
2009-02,South Dakota,1767,3402,5169,814180
2009-02,Tennessee,18514,12519,31033,6346105
2009-02,Texas,42121,31716,73837,25145561
2009-02,Utah,4319,4384,8703,2763885
2009-02,Vermont,1050,1182,2232,625741
2009-02,Virginia,16705,12591,29296,8001024
2009-02,Washington,11418,10296,21714,6724540
2009-02,West Virginia,5511,5859,11370,1852994
2009-02,Wisconsin,6283,10441,16724,5686986
2009-02,Wyoming,1701,2272,3973,563626
2009-01,Alabama,12280,12563,24843,4779736
2009-01,Arizona,8304,6642,14946,6392017
2009-01,Arkansas,5567,6446,12013,2915918
2009-01,California,21603,21205,42808,37253956
2009-01,Colorado,12325,11576,23901,5029196
2009-01,Connecticut,4130,3506,7636,3574097
2009-01,Delaware,971,848,1819,897934
2009-01,District of Columbia,33,1,34,601723
2009-01,Florida,29351,18574,47925,18801310
2009-01,Georgia,11415,9324,20739,9687653
2009-01,Idaho,2404,3506,5910,1567582
2009-01,Illinois,9012,9485,18497,12830632
2009-01,Indiana,11648,10284,21932,6483802
2009-01,Iowa,35,3305,3340,3046355
2009-01,Kansas,6488,6418,12906,2853118
2009-01,Kentucky,8922,8631,17553,4339367
2009-01,Louisiana,9366,10487,19853,4533372
2009-01,Maine,1721,2195,3916,1328361
2009-01,Maryland,4456,4108,8564,5773552
2009-01,Massachusetts,2570,1820,4390,6547629
2009-01,Michigan,2403,9604,12007,9883640
2009-01,Minnesota,5561,7035,12596,5303925
2009-01,Mississippi,5456,7611,13067,2967297
2009-01,Missouri,15627,12613,28240,5988927
2009-01,Montana,2056,3049,5105,989415
2009-01,Nebraska,8,2366,2374,1826341
2009-01,Nevada,4663,3623,8286,2700551
2009-01,New Hampshire,2444,2279,4723,1316470
2009-01,New Jersey,2216,1915,4131,8791894
2009-01,New Mexico,3759,3966,7725,2059179
2009-01,New York,4512,11128,15640,19378102
2009-01,North Carolina,268,13042,13310,9535483
2009-01,North Dakota,888,2140,3028,672591
2009-01,Ohio,17698,12963,30661,11536504
2009-01,Oklahoma,9907,8648,18555,3751351
2009-01,Oregon,7610,8616,16226,3831074
2009-01,Pennsylvania,0,54359,54359,12702379
2009-01,Rhode Island,642,506,1148,1052567
2009-01,South Carolina,7516,5355,12871,4625364
2009-01,South Dakota,1689,3345,5034,814180
2009-01,Tennessee,16542,12075,28617,6346105
2009-01,Texas,36799,33028,69827,25145561
2009-01,Utah,4608,4488,9096,2763885
2009-01,Vermont,726,832,1558,625741
2009-01,Virginia,14276,12469,26745,8001024
2009-01,Washington,10586,9757,20343,6724540
2009-01,West Virginia,4401,5499,9900,1852994
2009-01,Wisconsin,5678,8160,13838,5686986
2009-01,Wyoming,1666,2011,3677,563626
2008-12,Alabama,15385,26683,42068,4779736
2008-12,Arizona,10123,10513,20636,6392017
2008-12,Arkansas,7059,14108,21167,2915918
2008-12,California,24309,26068,50377,37253956
2008-12,Colorado,14749,17812,32561,5029196
2008-12,Connecticut,3747,4425,8172,3574097
2008-12,Delaware,978,1581,2559,897934
2008-12,District of Columbia,44,0,44,601723
2008-12,Florida,33392,29358,62750,18801310
2008-12,Georgia,14062,21198,35260,9687653
2008-12,Idaho,3165,5862,9027,1567582
2008-12,Illinois,9701,13434,23135,12830632
2008-12,Indiana,11452,16061,27513,6483802
2008-12,Iowa,51,6248,6299,3046355
2008-12,Kansas,6395,10157,16552,2853118
2008-12,Kentucky,11915,18364,30279,4339367
2008-12,Louisiana,13354,25588,38942,4533372
2008-12,Maine,1814,3503,5317,1328361
2008-12,Maryland,4756,6398,11154,5773552
2008-12,Massachusetts,2369,2119,4488,6547629
2008-12,Michigan,2411,16079,18490,9883640
2008-12,Minnesota,5993,10590,16583,5303925
2008-12,Mississippi,6655,19709,26364,2967297
2008-12,Missouri,17072,20694,37766,5988927
2008-12,Montana,2561,5621,8182,989415
2008-12,Nebraska,19,4946,4965,1826341
2008-12,Nevada,5944,5638,11582,2700551
2008-12,New Hampshire,2292,2504,4796,1316470
2008-12,New Jersey,1834,2694,4528,8791894
2008-12,New Mexico,4884,6680,11564,2059179
2008-12,New York,4197,16496,20693,19378102
2008-12,North Carolina,336,26690,27026,9535483
2008-12,North Dakota,1003,3094,4097,672591
2008-12,Ohio,20128,22613,42741,11536504
2008-12,Oklahoma,11529,15720,27249,3751351
2008-12,Oregon,7731,12699,20430,3831074
2008-12,Pennsylvania,1,67572,67573,12702379
2008-12,Rhode Island,630,608,1238,1052567
2008-12,South Carolina,9029,11739,20768,4625364
2008-12,South Dakota,1984,5447,7431,814180
2008-12,Tennessee,19508,21338,40846,6346105
2008-12,Texas,48954,67663,116617,25145561
2008-12,Utah,5548,9077,14625,2763885
2008-12,Vermont,731,1261,1992,625741
2008-12,Virginia,16273,21184,37457,8001024
2008-12,Washington,10945,13248,24193,6724540
2008-12,West Virginia,5839,11244,17083,1852994
2008-12,Wisconsin,6296,11967,18263,5686986
2008-12,Wyoming,2277,3567,5844,563626
2008-11,Alabama,13329,21562,34891,4779736
2008-11,Arizona,8851,9306,18157,6392017
2008-11,Arkansas,5997,12778,18775,2915918
2008-11,California,23123,26912,50035,37253956
2008-11,Colorado,16668,19911,36579,5029196
2008-11,Connecticut,3829,5384,9213,3574097
2008-11,Delaware,914,1524,2438,897934
2008-11,District of Columbia,54,0,54,601723
2008-11,Florida,33870,28509,62379,18801310
2008-11,Georgia,12723,16897,29620,9687653
2008-11,Idaho,3038,5774,8812,1567582
2008-11,Illinois,8864,14439,23303,12830632
2008-11,Indiana,10541,18501,29042,6483802
2008-11,Iowa,41,6829,6870,3046355
2008-11,Kansas,6259,10554,16813,2853118
2008-11,Kentucky,9095,15827,24922,4339367
2008-11,Louisiana,12756,22360,35116,4533372
2008-11,Maine,1822,4237,6059,1328361
2008-11,Maryland,5513,7892,13405,5773552
2008-11,Massachusetts,2503,2857,5360,6547629
2008-11,Michigan,2451,20847,23298,9883640
2008-11,Minnesota,5060,14371,19431,5303925
2008-11,Mississippi,6874,16844,23718,2967297
2008-11,Missouri,15195,21263,36458,5988927
2008-11,Montana,2394,5508,7902,989415
2008-11,Nebraska,18,4819,4837,1826341
2008-11,Nevada,6018,5938,11956,2700551
2008-11,New Hampshire,2853,3486,6339,1316470
2008-11,New Jersey,1658,3219,4877,8791894
2008-11,New Mexico,4730,5813,10543,2059179
2008-11,New York,3823,20863,24686,19378102
2008-11,North Carolina,276,23861,24137,9535483
2008-11,North Dakota,979,3822,4801,672591
2008-11,Ohio,21284,28183,49467,11536504
2008-11,Oklahoma,12083,15797,27880,3751351
2008-11,Oregon,8973,12936,21909,3831074
2008-11,Pennsylvania,0,78173,78173,12702379
2008-11,Rhode Island,709,738,1447,1052567
2008-11,South Carolina,11372,11993,23365,4625364
2008-11,South Dakota,1569,5559,7128,814180
2008-11,Tennessee,18184,19871,38055,6346105
2008-11,Texas,50641,60497,111138,25145561
2008-11,Utah,5375,7606,12981,2763885
2008-11,Vermont,687,1673,2360,625741
2008-11,Virginia,16688,21895,38583,8001024
2008-11,Washington,11988,15191,27179,6724540
2008-11,West Virginia,4442,11499,15941,1852994
2008-11,Wisconsin,6604,16946,23550,5686986
2008-11,Wyoming,2259,3134,5393,563626
2008-10,Alabama,8671,12052,20723,4779736
2008-10,Arizona,5815,5790,11605,6392017
2008-10,Arkansas,3899,9028,12927,2915918
2008-10,California,17782,18270,36052,37253956
2008-10,Colorado,9892,13220,23112,5029196
2008-10,Connecticut,3151,3664,6815,3574097
2008-10,Delaware,680,997,1677,897934
2008-10,District of Columbia,47,1,48,601723
2008-10,Florida,23978,17396,41374,18801310
2008-10,Georgia,8650,11675,20325,9687653
2008-10,Idaho,1706,4582,6288,1567582
2008-10,Illinois,6422,9829,16251,12830632
2008-10,Indiana,8106,11693,19799,6483802
2008-10,Iowa,23,4906,4929,3046355
2008-10,Kansas,4258,6835,11093,2853118
2008-10,Kentucky,6343,10872,17215,4339367
2008-10,Louisiana,7580,17167,24747,4533372
2008-10,Maine,1695,5625,7320,1328361
2008-10,Maryland,3202,5118,8320,5773552
2008-10,Massachusetts,1953,1971,3924,6547629
2008-10,Michigan,2181,15751,17932,9883640
2008-10,Minnesota,4219,16992,21211,5303925
2008-10,Mississippi,4480,8741,13221,2967297
2008-10,Missouri,11515,16302,27817,5988927
2008-10,Montana,1714,6232,7946,989415
2008-10,Nebraska,4,3507,3511,1826341
2008-10,Nevada,4082,3554,7636,2700551
2008-10,New Hampshire,2156,3112,5268,1316470
2008-10,New Jersey,1622,2232,3854,8791894
2008-10,New Mexico,3462,4224,7686,2059179
2008-10,New York,3862,16464,20326,19378102
2008-10,North Carolina,188,14200,14388,9535483
2008-10,North Dakota,718,5091,5809,672591
2008-10,Ohio,13552,15219,28771,11536504
2008-10,Oklahoma,6289,8907,15196,3751351
2008-10,Oregon,5201,9051,14252,3831074
2008-10,Pennsylvania,0,54888,54888,12702379
2008-10,Rhode Island,527,537,1064,1052567
2008-10,South Carolina,4768,6291,11059,4625364
2008-10,South Dakota,1132,6665,7797,814180
2008-10,Tennessee,11614,12168,23782,6346105
2008-10,Texas,26729,39563,66292,25145561
2008-10,Utah,2270,4655,6925,2763885
2008-10,Vermont,672,1660,2332,625741
2008-10,Virginia,10881,13834,24715,8001024
2008-10,Washington,7896,11333,19229,6724540
2008-10,West Virginia,3437,8506,11943,1852994
2008-10,Wisconsin,4298,15795,20093,5686986
2008-10,Wyoming,1043,2165,3208,563626
2008-09,Alabama,6800,11200,18000,4779736
2008-09,Arizona,5314,5393,10707,6392017
2008-09,Arkansas,3030,6515,9545,2915918
2008-09,California,15612,16489,32101,37253956
2008-09,Colorado,7756,10614,18370,5029196
2008-09,Connecticut,2642,2838,5480,3574097
2008-09,Delaware,517,804,1321,897934
2008-09,District of Columbia,39,0,39,601723
2008-09,Florida,19209,12593,31802,18801310
2008-09,Georgia,6072,7421,13493,9687653
2008-09,Idaho,1530,4093,5623,1567582
2008-09,Illinois,5265,8084,13349,12830632
2008-09,Indiana,6047,8408,14455,6483802
2008-09,Iowa,17,3724,3741,3046355
2008-09,Kansas,2905,4764,7669,2853118
2008-09,Kentucky,5529,7524,13053,4339367
2008-09,Louisiana,5467,9719,15186,4533372
2008-09,Maine,1498,3806,5304,1328361
2008-09,Maryland,2598,3708,6306,5773552
2008-09,Massachusetts,1703,1562,3265,6547629
2008-09,Michigan,2007,13809,15816,9883640
2008-09,Minnesota,3906,15820,19726,5303925
2008-09,Mississippi,3163,5808,8971,2967297
2008-09,Missouri,8687,10349,19036,5988927
2008-09,Montana,1740,4856,6596,989415
2008-09,Nebraska,3,2616,2619,1826341
2008-09,Nevada,2809,2672,5481,2700551
2008-09,New Hampshire,1683,2274,3957,1316470
2008-09,New Jersey,1584,1555,3139,8791894
2008-09,New Mexico,2746,3446,6192,2059179
2008-09,New York,3440,13770,17210,19378102
2008-09,North Carolina,152,9776,9928,9535483
2008-09,North Dakota,585,3619,4204,672591
2008-09,Ohio,10193,11287,21480,11536504
2008-09,Oklahoma,5209,7083,12292,3751351
2008-09,Oregon,5149,9058,14207,3831074
2008-09,Pennsylvania,0,45924,45924,12702379
2008-09,Rhode Island,416,438,854,1052567
2008-09,South Carolina,4215,4709,8924,4625364
2008-09,South Dakota,1051,4770,5821,814180
2008-09,Tennessee,9053,8969,18022,6346105
2008-09,Texas,20206,33624,53830,25145561
2008-09,Utah,2167,4068,6235,2763885
2008-09,Vermont,611,1411,2022,625741
2008-09,Virginia,9266,10570,19836,8001024
2008-09,Washington,6488,9412,15900,6724540
2008-09,West Virginia,2912,5369,8281,1852994
2008-09,Wisconsin,3787,13429,17216,5686986
2008-09,Wyoming,1012,2226,3238,563626
2008-08,Alabama,8018,9809,17827,4779736
2008-08,Arizona,5496,5553,11049,6392017
2008-08,Arkansas,3272,5376,8648,2915918
2008-08,California,17263,17143,34406,37253956
2008-08,Colorado,8916,10236,19152,5029196
2008-08,Connecticut,2593,2618,5211,3574097
2008-08,Delaware,561,710,1271,897934
2008-08,District of Columbia,1,0,1,601723
2008-08,Florida,19929,12190,32119,18801310
2008-08,Georgia,7170,7336,14506,9687653
2008-08,Idaho,1611,3411,5022,1567582
2008-08,Illinois,5521,7899,13420,12830632
2008-08,Indiana,6615,8228,14843,6483802
2008-08,Iowa,23,2610,2633,3046355
2008-08,Kansas,3672,4831,8503,2853118
2008-08,Kentucky,5761,7585,13346,4339367
2008-08,Louisiana,6769,10402,17171,4533372
2008-08,Maine,1549,2901,4450,1328361
2008-08,Maryland,2597,3250,5847,5773552
2008-08,Massachusetts,1891,1495,3386,6547629
2008-08,Michigan,2054,10440,12494,9883640
2008-08,Minnesota,4050,10413,14463,5303925
2008-08,Mississippi,4029,6201,10230,2967297
2008-08,Missouri,10309,10787,21096,5988927
2008-08,Montana,1847,4029,5876,989415
2008-08,Nebraska,4,2215,2219,1826341
2008-08,Nevada,3489,2775,6264,2700551
2008-08,New Hampshire,1741,2037,3778,1316470
2008-08,New Jersey,1432,1390,2822,8791894
2008-08,New Mexico,3016,3361,6377,2059179
2008-08,New York,3237,9179,12416,19378102
2008-08,North Carolina,168,10282,10450,9535483
2008-08,North Dakota,550,2516,3066,672591
2008-08,Ohio,10455,10345,20800,11536504
2008-08,Oklahoma,6250,7182,13432,3751351
2008-08,Oregon,4923,6912,11835,3831074
2008-08,Pennsylvania,0,41569,41569,12702379
2008-08,Rhode Island,430,342,772,1052567
2008-08,South Carolina,4252,4847,9099,4625364
2008-08,South Dakota,1108,3795,4903,814180
2008-08,Tennessee,10621,9852,20473,6346105
2008-08,Texas,23142,33949,57091,25145561
2008-08,Utah,1976,3260,5236,2763885
2008-08,Vermont,661,869,1530,625741
2008-08,Virginia,9059,9577,18636,8001024
2008-08,Washington,6490,8427,14917,6724540
2008-08,West Virginia,3030,4817,7847,1852994
2008-08,Wisconsin,3607,9685,13292,5686986
2008-08,Wyoming,1027,1859,2886,563626
2008-07,Alabama,7721,7604,15325,4779736
2008-07,Arizona,5584,4282,9866,6392017
2008-07,Arkansas,3072,3728,6800,2915918
2008-07,California,17773,14853,32626,37253956
2008-07,Colorado,8106,7909,16015,5029196
2008-07,Connecticut,2753,2158,4911,3574097
2008-07,Delaware,565,522,1087,897934
2008-07,District of Columbia,0,1,1,601723
2008-07,Florida,21831,10780,32611,18801310
2008-07,Georgia,7019,5060,12079,9687653
2008-07,Idaho,1400,2569,3969,1567582
2008-07,Illinois,5375,5732,11107,12830632
2008-07,Indiana,6082,5998,12080,6483802
2008-07,Iowa,32,1703,1735,3046355
2008-07,Kansas,3191,3144,6335,2853118
2008-07,Kentucky,6014,5549,11563,4339367
2008-07,Louisiana,6367,6411,12778,4533372
2008-07,Maine,1290,2017,3307,1328361
2008-07,Maryland,3068,2458,5526,5773552
2008-07,Massachusetts,1533,1061,2594,6547629
2008-07,Michigan,1942,6986,8928,9883640
2008-07,Minnesota,3565,5861,9426,5303925
2008-07,Mississippi,3622,3615,7237,2967297
2008-07,Missouri,9283,7425,16708,5988927
2008-07,Montana,1716,3053,4769,989415
2008-07,Nebraska,6,1319,1325,1826341
2008-07,Nevada,3233,2102,5335,2700551
2008-07,New Hampshire,1694,1629,3323,1316470
2008-07,New Jersey,1573,1251,2824,8791894
2008-07,New Mexico,2845,2896,5741,2059179
2008-07,New York,3312,7014,10326,19378102
2008-07,North Carolina,157,7190,7347,9535483
2008-07,North Dakota,552,1806,2358,672591
2008-07,Ohio,10124,8893,19017,11536504
2008-07,Oklahoma,5543,4827,10370,3751351
2008-07,Oregon,4896,5980,10876,3831074
2008-07,Pennsylvania,0,38032,38032,12702379
2008-07,Rhode Island,410,326,736,1052567
2008-07,South Carolina,4372,3129,7501,4625364
2008-07,South Dakota,824,2033,2857,814180
2008-07,Tennessee,10258,7114,17372,6346105
2008-07,Texas,21521,21065,42586,25145561
2008-07,Utah,1978,2653,4631,2763885
2008-07,Vermont,660,840,1500,625741
2008-07,Virginia,9811,8040,17851,8001024
2008-07,Washington,6686,6654,13340,6724540
2008-07,West Virginia,3018,3673,6691,1852994
2008-07,Wisconsin,3448,5699,9147,5686986
2008-07,Wyoming,967,1505,2472,563626
2008-06,Alabama,7212,7196,14408,4779736
2008-06,Arizona,5471,4301,9772,6392017
2008-06,Arkansas,3245,3362,6607,2915918
2008-06,California,18065,14947,33012,37253956
2008-06,Colorado,8017,7825,15842,5029196
2008-06,Connecticut,2554,2123,4677,3574097
2008-06,Delaware,523,476,999,897934
2008-06,District of Columbia,0,16,16,601723
2008-06,Florida,21317,10823,32140,18801310
2008-06,Georgia,6697,4721,11418,9687653
2008-06,Idaho,1627,2923,4550,1567582
2008-06,Illinois,5228,5228,10456,12830632
2008-06,Indiana,5701,5690,11391,6483802
2008-06,Iowa,17,1663,1680,3046355
2008-06,Kansas,3292,2851,6143,2853118
2008-06,Kentucky,5696,5034,10730,4339367
2008-06,Louisiana,6605,5196,11801,4533372
2008-06,Maine,1420,1863,3283,1328361
2008-06,Maryland,2620,2539,5159,5773552
2008-06,Massachusetts,1602,1127,2729,6547629
2008-06,Michigan,1907,7336,9243,9883640
2008-06,Minnesota,3612,5949,9561,5303925
2008-06,Mississippi,3504,3179,6683,2967297
2008-06,Missouri,9100,7286,16386,5988927
2008-06,Montana,1746,3479,5225,989415
2008-06,Nebraska,4,1256,1260,1826341
2008-06,Nevada,2517,1801,4318,2700551
2008-06,New Hampshire,1735,1785,3520,1316470
2008-06,New Jersey,1503,1124,2627,8791894
2008-06,New Mexico,2985,3098,6083,2059179
2008-06,New York,3099,7173,10272,19378102
2008-06,North Carolina,190,7042,7232,9535483
2008-06,North Dakota,595,1819,2414,672591
2008-06,Ohio,9483,8069,17552,11536504
2008-06,Oklahoma,5447,4631,10078,3751351
2008-06,Oregon,5220,7084,12304,3831074
2008-06,Pennsylvania,0,35944,35944,12702379
2008-06,Rhode Island,377,296,673,1052567
2008-06,South Carolina,4198,2754,6952,4625364
2008-06,South Dakota,877,1994,2871,814180
2008-06,Tennessee,9823,6702,16525,6346105
2008-06,Texas,22732,20558,43290,25145561
2008-06,Utah,2027,3059,5086,2763885
2008-06,Vermont,573,651,1224,625741
2008-06,Virginia,7661,6765,14426,8001024
2008-06,Washington,7067,7939,15006,6724540
2008-06,West Virginia,2760,3511,6271,1852994
2008-06,Wisconsin,3420,6108,9528,5686986
2008-06,Wyoming,1062,1574,2636,563626
2008-05,Alabama,7993,7889,15882,4779736
2008-05,Arizona,6553,5000,11553,6392017
2008-05,Arkansas,3407,3586,6993,2915918
2008-05,California,18442,16004,34446,37253956
2008-05,Colorado,8469,8336,16805,5029196
2008-05,Connecticut,2946,2374,5320,3574097
2008-05,Delaware,594,551,1145,897934
2008-05,District of Columbia,0,0,0,601723
2008-05,Florida,22085,11565,33650,18801310
2008-05,Georgia,7303,5135,12438,9687653
2008-05,Idaho,1819,3315,5134,1567582
2008-05,Illinois,6268,6334,12602,12830632
2008-05,Indiana,7065,6543,13608,6483802
2008-05,Iowa,30,1841,1871,3046355
2008-05,Kansas,3483,3306,6789,2853118
2008-05,Kentucky,6204,5802,12006,4339367
2008-05,Louisiana,6353,4974,11327,4533372
2008-05,Maine,1453,2106,3559,1328361
2008-05,Maryland,2862,2642,5504,5773552
2008-05,Massachusetts,1912,1208,3120,6547629
2008-05,Michigan,2026,8249,10275,9883640
2008-05,Minnesota,4072,6206,10278,5303925
2008-05,Mississippi,4015,3343,7358,2967297
2008-05,Missouri,10138,8025,18163,5988927
2008-05,Montana,1885,4303,6188,989415
2008-05,Nebraska,7,1422,1429,1826341
2008-05,Nevada,2818,2004,4822,2700551
2008-05,New Hampshire,1847,1846,3693,1316470
2008-05,New Jersey,1654,1262,2916,8791894
2008-05,New Mexico,3128,3087,6215,2059179
2008-05,New York,3571,8632,12203,19378102
2008-05,North Carolina,254,7720,7974,9535483
2008-05,North Dakota,689,1828,2517,672591
2008-05,Ohio,11634,9167,20801,11536504
2008-05,Oklahoma,6086,5451,11537,3751351
2008-05,Oregon,5676,7197,12873,3831074
2008-05,Pennsylvania,1,40339,40340,12702379
2008-05,Rhode Island,497,373,870,1052567
2008-05,South Carolina,4706,2914,7620,4625364
2008-05,South Dakota,1060,2277,3337,814180
2008-05,Tennessee,10393,6999,17392,6346105
2008-05,Texas,23216,21460,44676,25145561
2008-05,Utah,2537,3498,6035,2763885
2008-05,Vermont,662,898,1560,625741
2008-05,Virginia,9485,7777,17262,8001024
2008-05,Washington,7419,7598,15017,6724540
2008-05,West Virginia,3229,3863,7092,1852994
2008-05,Wisconsin,3951,7200,11151,5686986
2008-05,Wyoming,1134,1833,2967,563626
2008-04,Alabama,7947,7434,15381,4779736
2008-04,Arizona,6569,4968,11537,6392017
2008-04,Arkansas,3410,4165,7575,2915918
2008-04,California,18892,16152,35044,37253956
2008-04,Colorado,8592,8811,17403,5029196
2008-04,Connecticut,3151,2701,5852,3574097
2008-04,Delaware,666,624,1290,897934
2008-04,District of Columbia,0,0,0,601723
2008-04,Florida,22873,11925,34798,18801310
2008-04,Georgia,7386,5485,12871,9687653
2008-04,Idaho,1858,3474,5332,1567582
2008-04,Illinois,6230,6643,12873,12830632
2008-04,Indiana,6798,7163,13961,6483802
2008-04,Iowa,26,2931,2957,3046355
2008-04,Kansas,3982,3991,7973,2853118
2008-04,Kentucky,5904,6809,12713,4339367
2008-04,Louisiana,6576,5069,11645,4533372
2008-04,Maine,1500,2180,3680,1328361
2008-04,Maryland,2304,3040,5344,5773552
2008-04,Massachusetts,2116,1484,3600,6547629
2008-04,Michigan,2343,9766,12109,9883640
2008-04,Minnesota,5417,9752,15169,5303925
2008-04,Mississippi,3737,3457,7194,2967297
2008-04,Missouri,10621,10465,21086,5988927
2008-04,Montana,1883,3863,5746,989415
2008-04,Nebraska,6,1737,1743,1826341
2008-04,Nevada,2738,2119,4857,2700551
2008-04,New Hampshire,1911,2167,4078,1316470
2008-04,New Jersey,1624,1351,2975,8791894
2008-04,New Mexico,3016,3192,6208,2059179
2008-04,New York,3955,10703,14658,19378102
2008-04,North Carolina,206,8394,8600,9535483
2008-04,North Dakota,721,2104,2825,672591
2008-04,Ohio,12773,10745,23518,11536504
2008-04,Oklahoma,6830,6547,13377,3751351
2008-04,Oregon,6090,8196,14286,3831074
2008-04,Pennsylvania,0,45631,45631,12702379
2008-04,Rhode Island,450,376,826,1052567
2008-04,South Carolina,4714,3114,7828,4625364
2008-04,South Dakota,1226,2583,3809,814180
2008-04,Tennessee,10360,7144,17504,6346105
2008-04,Texas,22491,20257,42748,25145561
2008-04,Utah,2800,3500,6300,2763885
2008-04,Vermont,701,1162,1863,625741
2008-04,Virginia,12221,8622,20843,8001024
2008-04,Washington,7891,8233,16124,6724540
2008-04,West Virginia,3199,4379,7578,1852994
2008-04,Wisconsin,4802,11642,16444,5686986
2008-04,Wyoming,1120,1830,2950,563626
2008-03,Alabama,10021,10942,20963,4779736
2008-03,Arizona,6961,5394,12355,6392017
2008-03,Arkansas,4087,4980,9067,2915918
2008-03,California,21050,19758,40808,37253956
2008-03,Colorado,9748,9936,19684,5029196
2008-03,Connecticut,3517,3042,6559,3574097
2008-03,Delaware,666,656,1322,897934
2008-03,District of Columbia,0,0,0,601723
2008-03,Florida,23888,13781,37669,18801310
2008-03,Georgia,9057,7895,16952,9687653
2008-03,Idaho,2161,4018,6179,1567582
2008-03,Illinois,8214,9393,17607,12830632
2008-03,Indiana,9545,9961,19506,6483802
2008-03,Iowa,38,4141,4179,3046355
2008-03,Kansas,4660,4719,9379,2853118
2008-03,Kentucky,7352,8536,15888,4339367
2008-03,Louisiana,7566,6554,14120,4533372
2008-03,Maine,1803,2390,4193,1328361
2008-03,Maryland,2446,3454,5900,5773552
2008-03,Massachusetts,2540,1710,4250,6547629
2008-03,Michigan,2771,12182,14953,9883640
2008-03,Minnesota,5819,10560,16379,5303925
2008-03,Mississippi,4495,5055,9550,2967297
2008-03,Missouri,13170,12317,25487,5988927
2008-03,Montana,2071,4153,6224,989415
2008-03,Nebraska,11,2178,2189,1826341
2008-03,Nevada,3519,2651,6170,2700551
2008-03,New Hampshire,1983,2094,4077,1316470
2008-03,New Jersey,1664,1591,3255,8791894
2008-03,New Mexico,3485,3816,7301,2059179
2008-03,New York,4263,11056,15319,19378102
2008-03,North Carolina,289,10270,10559,9535483
2008-03,North Dakota,857,2370,3227,672591
2008-03,Ohio,15096,12216,27312,11536504
2008-03,Oklahoma,7121,6599,13720,3751351
2008-03,Oregon,6730,9643,16373,3831074
2008-03,Pennsylvania,0,55553,55553,12702379
2008-03,Rhode Island,560,443,1003,1052567
2008-03,South Carolina,6156,4534,10690,4625364
2008-03,South Dakota,1439,2899,4338,814180
2008-03,Tennessee,11968,9589,21557,6346105
2008-03,Texas,26012,23400,49412,25145561
2008-03,Utah,2836,3952,6788,2763885
2008-03,Vermont,802,1212,2014,625741
2008-03,Virginia,12481,9553,22034,8001024
2008-03,Washington,8423,9169,17592,6724540
2008-03,West Virginia,4175,5142,9317,1852994
2008-03,Wisconsin,5257,14027,19284,5686986
2008-03,Wyoming,1347,2037,3384,563626
2008-02,Alabama,10248,11972,22220,4779736
2008-02,Arizona,7710,5991,13701,6392017
2008-02,Arkansas,5245,6391,11636,2915918
2008-02,California,17693,15933,33626,37253956
2008-02,Colorado,9169,9438,18607,5029196
2008-02,Connecticut,3068,2730,5798,3574097
2008-02,Delaware,629,703,1332,897934
2008-02,District of Columbia,1,52,53,601723
2008-02,Florida,23891,14570,38461,18801310
2008-02,Georgia,10542,8896,19438,9687653
2008-02,Idaho,2018,3605,5623,1567582
2008-02,Illinois,7275,8002,15277,12830632
2008-02,Indiana,8796,8951,17747,6483802
2008-02,Iowa,30,3184,3214,3046355
2008-02,Kansas,4522,4569,9091,2853118
2008-02,Kentucky,8925,9523,18448,4339367
2008-02,Louisiana,8438,7284,15722,4533372
2008-02,Maine,1356,1995,3351,1328361
2008-02,Maryland,2688,3809,6497,5773552
2008-02,Massachusetts,1986,1322,3308,6547629
2008-02,Michigan,2291,10296,12587,9883640
2008-02,Minnesota,4671,8015,12686,5303925
2008-02,Mississippi,5843,6247,12090,2967297
2008-02,Missouri,12985,12143,25128,5988927
2008-02,Montana,1817,3332,5149,989415
2008-02,Nebraska,13,2085,2098,1826341
2008-02,Nevada,3209,2344,5553,2700551
2008-02,New Hampshire,1797,1722,3519,1316470
2008-02,New Jersey,1483,1461,2944,8791894
2008-02,New Mexico,3496,3861,7357,2059179
2008-02,New York,3766,10003,13769,19378102
2008-02,North Carolina,330,11974,12304,9535483
2008-02,North Dakota,718,1968,2686,672591
2008-02,Ohio,14693,11940,26633,11536504
2008-02,Oklahoma,7937,7510,15447,3751351
2008-02,Oregon,5848,7882,13730,3831074
2008-02,Pennsylvania,0,46330,46330,12702379
2008-02,Rhode Island,441,437,878,1052567
2008-02,South Carolina,7339,5176,12515,4625364
2008-02,South Dakota,1335,2856,4191,814180
2008-02,Tennessee,13818,10829,24647,6346105
2008-02,Texas,27766,25882,53648,25145561
2008-02,Utah,2687,4137,6824,2763885
2008-02,Vermont,775,1137,1912,625741
2008-02,Virginia,13359,10525,23884,8001024
2008-02,Washington,8534,8546,17080,6724540
2008-02,West Virginia,4220,5402,9622,1852994
2008-02,Wisconsin,4853,10213,15066,5686986
2008-02,Wyoming,1169,1785,2954,563626
2008-01,Alabama,9304,9156,18460,4779736
2008-01,Arizona,6176,5162,11338,6392017
2008-01,Arkansas,3696,5681,9377,2915918
2008-01,California,17524,15080,32604,37253956
2008-01,Colorado,7893,8324,16217,5029196
2008-01,Connecticut,3283,2996,6279,3574097
2008-01,Delaware,529,693,1222,897934
2008-01,District of Columbia,1,0,1,601723
2008-01,Florida,21902,14496,36398,18801310
2008-01,Georgia,8618,8225,16843,9687653
2008-01,Idaho,1609,2983,4592,1567582
2008-01,Illinois,6366,7633,13999,12830632
2008-01,Indiana,8132,8355,16487,6483802
2008-01,Iowa,27,2986,3013,3046355
2008-01,Kansas,3953,4583,8536,2853118
2008-01,Kentucky,7357,8139,15496,4339367
2008-01,Louisiana,7101,8290,15391,4533372
2008-01,Maine,1341,1771,3112,1328361
2008-01,Maryland,2262,3243,5505,5773552
2008-01,Massachusetts,2076,1491,3567,6547629
2008-01,Michigan,2234,9252,11486,9883640
2008-01,Minnesota,4206,6493,10699,5303925
2008-01,Mississippi,4556,8022,12578,2967297
2008-01,Missouri,10799,10749,21548,5988927
2008-01,Montana,1336,2655,3991,989415
2008-01,Nebraska,7,1970,1977,1826341
2008-01,Nevada,2390,1930,4320,2700551
2008-01,New Hampshire,1786,1778,3564,1316470
2008-01,New Jersey,1411,1589,3000,8791894
2008-01,New Mexico,2808,3159,5967,2059179
2008-01,New York,3799,9442,13241,19378102
2008-01,North Carolina,224,10862,11086,9535483
2008-01,North Dakota,699,1984,2683,672591
2008-01,Ohio,12322,13587,25909,11536504
2008-01,Oklahoma,6291,6573,12864,3751351
2008-01,Oregon,5439,6638,12077,3831074
2008-01,Pennsylvania,0,44398,44398,12702379
2008-01,Rhode Island,422,401,823,1052567
2008-01,South Carolina,5136,4754,9890,4625364
2008-01,South Dakota,1107,2560,3667,814180
2008-01,Tennessee,11125,9150,20275,6346105
2008-01,Texas,24005,26358,50363,25145561
2008-01,Utah,2424,3734,6158,2763885
2008-01,Vermont,567,725,1292,625741
2008-01,Virginia,9903,9371,19274,8001024
2008-01,Washington,7637,7277,14914,6724540
2008-01,West Virginia,3326,4727,8053,1852994
2008-01,Wisconsin,3679,7574,11253,5686986
2008-01,Wyoming,885,1499,2384,563626
2007-12,Alabama,10877,23192,34069,4779736
2007-12,Arizona,7678,9370,17048,6392017
2007-12,Arkansas,4741,13939,18680,2915918
2007-12,California,18279,20378,38657,37253956
2007-12,Colorado,9359,14562,23921,5029196
2007-12,Connecticut,3077,3558,6635,3574097
2007-12,Delaware,597,1508,2105,897934
2007-12,District of Columbia,1,0,1,601723
2007-12,Florida,23703,24625,48328,18801310
2007-12,Georgia,10296,21868,32164,9687653
2007-12,Idaho,2364,6581,8945,1567582
2007-12,Illinois,6639,12126,18765,12830632
2007-12,Indiana,7943,14213,22156,6483802
2007-12,Iowa,23,6371,6394,3046355
2007-12,Kansas,3946,8716,12662,2853118
2007-12,Kentucky,9547,17620,27167,4339367
2007-12,Louisiana,8474,22360,30834,4533372
2007-12,Maine,1172,3138,4310,1328361
2007-12,Maryland,2093,5974,8067,5773552
2007-12,Massachusetts,1970,1687,3657,6547629
2007-12,Michigan,2327,17095,19422,9883640
2007-12,Minnesota,4258,11430,15688,5303925
2007-12,Mississippi,5073,19981,25054,2967297
2007-12,Missouri,11779,19402,31181,5988927
2007-12,Montana,2108,5903,8011,989415
2007-12,Nebraska,1,4774,4775,1826341
2007-12,Nevada,3255,3832,7087,2700551
2007-12,New Hampshire,1650,2415,4065,1316470
2007-12,New Jersey,1270,2355,3625,8791894
2007-12,New Mexico,3509,5988,9497,2059179
2007-12,New York,3263,14674,17937,19378102
2007-12,North Carolina,265,24934,25199,9535483
2007-12,North Dakota,656,3125,3781,672591
2007-12,Ohio,13589,22970,36559,11536504
2007-12,Oklahoma,6978,13444,20422,3751351
2007-12,Oregon,6502,13106,19608,3831074
2007-12,Pennsylvania,0,53300,53300,12702379
2007-12,Rhode Island,358,490,848,1052567
2007-12,South Carolina,6008,11940,17948,4625364
2007-12,South Dakota,1088,4696,5784,814180
2007-12,Tennessee,13549,21021,34570,6346105
2007-12,Texas,30442,58440,88882,25145561
2007-12,Utah,3542,9392,12934,2763885
2007-12,Vermont,513,1257,1770,625741
2007-12,Virginia,11571,18884,30455,8001024
2007-12,Washington,7995,12543,20538,6724540
2007-12,West Virginia,4051,9789,13840,1852994
2007-12,Wisconsin,4178,12216,16394,5686986
2007-12,Wyoming,1284,3314,4598,563626
2007-11,Alabama,7144,16218,23362,4779736
2007-11,Arizona,5306,6280,11586,6392017
2007-11,Arkansas,2973,11585,14558,2915918
2007-11,California,16000,17876,33876,37253956
2007-11,Colorado,7016,11638,18654,5029196
2007-11,Connecticut,2788,3462,6250,3574097
2007-11,Delaware,460,1231,1691,897934
2007-11,District of Columbia,0,0,0,601723
2007-11,Florida,18959,18123,37082,18801310
2007-11,Georgia,6257,13484,19741,9687653
2007-11,Idaho,1532,4578,6110,1567582
2007-11,Illinois,5377,11499,16876,12830632
2007-11,Indiana,6508,14549,21057,6483802
2007-11,Iowa,33,6855,6888,3046355
2007-11,Kansas,3038,8267,11305,2853118
2007-11,Kentucky,6122,13173,19295,4339367
2007-11,Louisiana,5545,16178,21723,4533372
2007-11,Maine,1083,3562,4645,1328361
2007-11,Maryland,1763,6045,7808,5773552
2007-11,Massachusetts,1748,1861,3609,6547629
2007-11,Michigan,1843,19169,21012,9883640
2007-11,Minnesota,2984,11054,14038,5303925
2007-11,Mississippi,3319,16248,19567,2967297
2007-11,Missouri,8292,15950,24242,5988927
2007-11,Montana,1358,4039,5397,989415
2007-11,Nebraska,0,4077,4077,1826341
2007-11,Nevada,2179,2663,4842,2700551
2007-11,New Hampshire,1546,2592,4138,1316470
2007-11,New Jersey,1239,2511,3750,8791894
2007-11,New Mexico,2563,4108,6671,2059179
2007-11,New York,2934,16062,18996,19378102
2007-11,North Carolina,209,18387,18596,9535483
2007-11,North Dakota,453,3294,3747,672591
2007-11,Ohio,10308,23350,33658,11536504
2007-11,Oklahoma,4681,10130,14811,3751351
2007-11,Oregon,5000,8646,13646,3831074
2007-11,Pennsylvania,0,55498,55498,12702379
2007-11,Rhode Island,334,492,826,1052567
2007-11,South Carolina,3898,7987,11885,4625364
2007-11,South Dakota,728,4620,5348,814180
2007-11,Tennessee,9250,15432,24682,6346105
2007-11,Texas,19042,37621,56663,25145561
2007-11,Utah,2539,6139,8678,2763885
2007-11,Vermont,452,1480,1932,625741
2007-11,Virginia,8729,15816,24545,8001024
2007-11,Washington,6612,9469,16081,6724540
2007-11,West Virginia,2583,9690,12273,1852994
2007-11,Wisconsin,3399,16032,19431,5686986
2007-11,Wyoming,908,2202,3110,563626
2007-10,Alabama,6484,10262,16746,4779736
2007-10,Arizona,5171,5736,10907,6392017
2007-10,Arkansas,2845,8662,11507,2915918
2007-10,California,15250,15040,30290,37253956
2007-10,Colorado,6768,11167,17935,5029196
2007-10,Connecticut,2958,3131,6089,3574097
2007-10,Delaware,501,886,1387,897934
2007-10,District of Columbia,3,0,3,601723
2007-10,Florida,18709,15066,33775,18801310
2007-10,Georgia,5810,11085,16895,9687653
2007-10,Idaho,1457,4742,6199,1567582
2007-10,Illinois,5503,9571,15074,12830632
2007-10,Indiana,5491,9858,15349,6483802
2007-10,Iowa,14,5261,5275,3046355
2007-10,Kansas,3280,6405,9685,2853118
2007-10,Kentucky,5768,10749,16517,4339367
2007-10,Louisiana,6113,13402,19515,4533372
2007-10,Maine,1414,5843,7257,1328361
2007-10,Maryland,1943,4589,6532,5773552
2007-10,Massachusetts,1769,1738,3507,6547629
2007-10,Michigan,1901,15839,17740,9883640
2007-10,Minnesota,3438,18622,22060,5303925
2007-10,Mississippi,3378,9528,12906,2967297
2007-10,Missouri,9728,15754,25482,5988927
2007-10,Montana,1484,6554,8038,989415
2007-10,Nebraska,0,3664,3664,1826341
2007-10,Nevada,2209,2015,4224,2700551
2007-10,New Hampshire,1580,2923,4503,1316470
2007-10,New Jersey,1303,1969,3272,8791894
2007-10,New Mexico,2730,3698,6428,2059179
2007-10,New York,3227,15540,18767,19378102
2007-10,North Carolina,194,13016,13210,9535483
2007-10,North Dakota,518,5127,5645,672591
2007-10,Ohio,9598,16284,25882,11536504
2007-10,Oklahoma,5318,8521,13839,3751351
2007-10,Oregon,4412,8032,12444,3831074
2007-10,Pennsylvania,0,51900,51900,12702379
2007-10,Rhode Island,377,455,832,1052567
2007-10,South Carolina,3832,5818,9650,4625364
2007-10,South Dakota,786,6571,7357,814180
2007-10,Tennessee,8917,11361,20278,6346105
2007-10,Texas,18392,32269,50661,25145561
2007-10,Utah,2012,5083,7095,2763885
2007-10,Vermont,533,1696,2229,625741
2007-10,Virginia,8479,11801,20280,8001024
2007-10,Washington,6882,9622,16504,6724540
2007-10,West Virginia,2613,7557,10170,1852994
2007-10,Wisconsin,3607,16496,20103,5686986
2007-10,Wyoming,785,2185,2970,563626
2007-09,Alabama,6361,9837,16198,4779736
2007-09,Arizona,5468,5778,11246,6392017
2007-09,Arkansas,2715,7149,9864,2915918
2007-09,California,14631,15650,30281,37253956
2007-09,Colorado,6214,9780,15994,5029196
2007-09,Connecticut,2010,2167,4177,3574097
2007-09,Delaware,477,702,1179,897934
2007-09,District of Columbia,1,0,1,601723
2007-09,Florida,17555,13315,30870,18801310
2007-09,Georgia,5589,8574,14163,9687653
2007-09,Idaho,1679,4838,6517,1567582
2007-09,Illinois,4638,7590,12228,12830632
2007-09,Indiana,5002,8163,13165,6483802
2007-09,Iowa,14,3685,3699,3046355
2007-09,Kansas,2878,5326,8204,2853118
2007-09,Kentucky,5356,8547,13903,4339367
2007-09,Louisiana,5572,10055,15627,4533372
2007-09,Maine,1383,4066,5449,1328361
2007-09,Maryland,1615,3658,5273,5773552
2007-09,Massachusetts,1534,1411,2945,6547629
2007-09,Michigan,1685,14585,16270,9883640
2007-09,Minnesota,3537,16878,20415,5303925
2007-09,Mississippi,3000,7143,10143,2967297
2007-09,Missouri,10468,11745,22213,5988927
2007-09,Montana,1642,5567,7209,989415
2007-09,Nebraska,0,2816,2816,1826341
2007-09,Nevada,2097,2165,4262,2700551
2007-09,New Hampshire,1554,2703,4257,1316470
2007-09,New Jersey,1227,1539,2766,8791894
2007-09,New Mexico,2487,3463,5950,2059179
2007-09,New York,2992,13961,16953,19378102
2007-09,North Carolina,181,11052,11233,9535483
2007-09,North Dakota,506,3729,4235,672591
2007-09,Ohio,8506,14391,22897,11536504
2007-09,Oklahoma,4390,6956,11346,3751351
2007-09,Oregon,4751,10062,14813,3831074
2007-09,Pennsylvania,0,45529,45529,12702379
2007-09,Rhode Island,330,404,734,1052567
2007-09,South Carolina,3573,5140,8713,4625364
2007-09,South Dakota,831,4743,5574,814180
2007-09,Tennessee,8158,9396,17554,6346105
2007-09,Texas,17096,33983,51079,25145561
2007-09,Utah,2132,5106,7238,2763885
2007-09,Vermont,565,1408,1973,625741
2007-09,Virginia,11689,10323,22012,8001024
2007-09,Washington,5705,9207,14912,6724540
2007-09,West Virginia,2515,6045,8560,1852994
2007-09,Wisconsin,3453,14404,17857,5686986
2007-09,Wyoming,840,2451,3291,563626
2007-08,Alabama,7155,7975,15130,4779736
2007-08,Arizona,5604,6373,11977,6392017
2007-08,Arkansas,2948,5478,8426,2915918
2007-08,California,15483,17331,32814,37253956
2007-08,Colorado,7146,9911,17057,5029196
2007-08,Connecticut,2257,2148,4405,3574097
2007-08,Delaware,480,658,1138,897934
2007-08,District of Columbia,1,0,1,601723
2007-08,Florida,19278,12899,32177,18801310
2007-08,Georgia,6537,8541,15078,9687653
2007-08,Idaho,1601,3795,5396,1567582
2007-08,Illinois,5159,8193,13352,12830632
2007-08,Indiana,5944,8451,14395,6483802
2007-08,Iowa,19,2822,2841,3046355
2007-08,Kansas,3155,4988,8143,2853118
2007-08,Kentucky,5814,8072,13886,4339367
2007-08,Louisiana,5938,9086,15024,4533372
2007-08,Maine,1195,2669,3864,1328361
2007-08,Maryland,1744,3492,5236,5773552
2007-08,Massachusetts,1773,1320,3093,6547629
2007-08,Michigan,1929,10959,12888,9883640
2007-08,Minnesota,3755,12143,15898,5303925
2007-08,Mississippi,3616,7109,10725,2967297
2007-08,Missouri,6769,11859,18628,5988927
2007-08,Montana,1741,4297,6038,989415
2007-08,Nebraska,3,2442,2445,1826341
2007-08,Nevada,2571,2157,4728,2700551
2007-08,New Hampshire,1347,1973,3320,1316470
2007-08,New Jersey,1403,1444,2847,8791894
2007-08,New Mexico,2751,3335,6086,2059179
2007-08,New York,3181,9579,12760,19378102
2007-08,North Carolina,204,10690,10894,9535483
2007-08,North Dakota,476,2425,2901,672591
2007-08,Ohio,8688,11876,20564,11536504
2007-08,Oklahoma,5187,7372,12559,3751351
2007-08,Oregon,4530,7346,11876,3831074
2007-08,Pennsylvania,0,46903,46903,12702379
2007-08,Rhode Island,339,368,707,1052567
2007-08,South Carolina,3760,5010,8770,4625364
2007-08,South Dakota,827,3347,4174,814180
2007-08,Tennessee,8705,9930,18635,6346105
2007-08,Texas,18786,33112,51898,25145561
2007-08,Utah,2098,4196,6294,2763885
2007-08,Vermont,530,919,1449,625741
2007-08,Virginia,12187,9222,21409,8001024
2007-08,Washington,6214,8031,14245,6724540
2007-08,West Virginia,2770,4840,7610,1852994
2007-08,Wisconsin,3331,10834,14165,5686986
2007-08,Wyoming,918,2052,2970,563626
2007-07,Alabama,6172,5382,11554,4779736
2007-07,Arizona,5425,4623,10048,6392017
2007-07,Arkansas,2915,3566,6481,2915918
2007-07,California,14613,13984,28597,37253956
2007-07,Colorado,6422,6769,13191,5029196
2007-07,Connecticut,2174,1709,3883,3574097
2007-07,Delaware,413,515,928,897934
2007-07,District of Columbia,2,0,2,601723
2007-07,Florida,17668,10513,28181,18801310
2007-07,Georgia,5640,5370,11010,9687653
2007-07,Idaho,1410,2554,3964,1567582
2007-07,Illinois,4348,5158,9506,12830632
2007-07,Indiana,4908,5919,10827,6483802
2007-07,Iowa,8,1634,1642,3046355
2007-07,Kansas,2602,2850,5452,2853118
2007-07,Kentucky,5244,5737,10981,4339367
2007-07,Louisiana,5982,5484,11466,4533372
2007-07,Maine,1070,1928,2998,1328361
2007-07,Maryland,1653,2501,4154,5773552
2007-07,Massachusetts,1516,1003,2519,6547629
2007-07,Michigan,1732,7462,9194,9883640
2007-07,Minnesota,2750,6039,8789,5303925
2007-07,Mississippi,3376,4276,7652,2967297
2007-07,Missouri,3701,7137,10838,5988927
2007-07,Montana,1467,2779,4246,989415
2007-07,Nebraska,0,1393,1393,1826341
2007-07,Nevada,2110,1544,3654,2700551
2007-07,New Hampshire,1325,1575,2900,1316470
2007-07,New Jersey,1303,1191,2494,8791894
2007-07,New Mexico,2415,2609,5024,2059179
2007-07,New York,3163,7363,10526,19378102
2007-07,North Carolina,149,6783,6932,9535483
2007-07,North Dakota,390,1634,2024,672591
2007-07,Ohio,8292,11280,19572,11536504
2007-07,Oklahoma,4681,4677,9358,3751351
2007-07,Oregon,4153,5806,9959,3831074
2007-07,Pennsylvania,0,38698,38698,12702379
2007-07,Rhode Island,310,306,616,1052567
2007-07,South Carolina,3334,3177,6511,4625364
2007-07,South Dakota,646,1994,2640,814180
2007-07,Tennessee,8383,6746,15129,6346105
2007-07,Texas,17474,19767,37241,25145561
2007-07,Utah,1916,2931,4847,2763885
2007-07,Vermont,527,724,1251,625741
2007-07,Virginia,8139,7588,15727,8001024
2007-07,Washington,5760,6002,11762,6724540
2007-07,West Virginia,2472,3667,6139,1852994
2007-07,Wisconsin,2728,6362,9090,5686986
2007-07,Wyoming,797,1445,2242,563626
2007-06,Alabama,6828,5366,12194,4779736
2007-06,Arizona,5699,4586,10285,6392017
2007-06,Arkansas,2887,3371,6258,2915918
2007-06,California,16526,14184,30710,37253956
2007-06,Colorado,6503,7012,13515,5029196
2007-06,Connecticut,2259,1811,4070,3574097
2007-06,Delaware,462,508,970,897934
2007-06,District of Columbia,3,1,4,601723
2007-06,Florida,19377,11646,31023,18801310
2007-06,Georgia,6136,4948,11084,9687653
2007-06,Idaho,1643,2752,4395,1567582
2007-06,Illinois,4699,5062,9761,12830632
2007-06,Indiana,5728,5827,11555,6483802
2007-06,Iowa,10,1647,1657,3046355
2007-06,Kansas,2980,2805,5785,2853118
2007-06,Kentucky,5597,5447,11044,4339367
2007-06,Louisiana,6055,4729,10784,4533372
2007-06,Maine,1122,1695,2817,1328361
2007-06,Maryland,1502,2558,4060,5773552
2007-06,Massachusetts,1771,1126,2897,6547629
2007-06,Michigan,1732,7078,8810,9883640
2007-06,Minnesota,3095,5755,8850,5303925
2007-06,Mississippi,3469,3481,6950,2967297
2007-06,Missouri,4602,7383,11985,5988927
2007-06,Montana,1582,3297,4879,989415
2007-06,Nebraska,1,1271,1272,1826341
2007-06,Nevada,2434,1863,4297,2700551
2007-06,New Hampshire,1531,1643,3174,1316470
2007-06,New Jersey,1493,1278,2771,8791894
2007-06,New Mexico,2890,2775,5665,2059179
2007-06,New York,3245,7131,10376,19378102
2007-06,North Carolina,171,7144,7315,9535483
2007-06,North Dakota,430,1466,1896,672591
2007-06,Ohio,8661,11526,20187,11536504
2007-06,Oklahoma,5249,4579,9828,3751351
2007-06,Oregon,5071,6751,11822,3831074
2007-06,Pennsylvania,0,40076,40076,12702379
2007-06,Rhode Island,347,298,645,1052567
2007-06,South Carolina,3764,2746,6510,4625364
2007-06,South Dakota,732,1880,2612,814180
2007-06,Tennessee,8957,6523,15480,6346105
2007-06,Texas,18556,18695,37251,25145561
2007-06,Utah,2234,3210,5444,2763885
2007-06,Vermont,481,633,1114,625741
2007-06,Virginia,7376,6836,14212,8001024
2007-06,Washington,6233,6635,12868,6724540
2007-06,West Virginia,2634,3176,5810,1852994
2007-06,Wisconsin,2803,6019,8822,5686986
2007-06,Wyoming,1008,1604,2612,563626
2007-05,Alabama,6806,4847,11653,4779736
2007-05,Arizona,5800,4412,10212,6392017
2007-05,Arkansas,2805,3315,6120,2915918
2007-05,California,16798,14460,31258,37253956
2007-05,Colorado,6864,7066,13930,5029196
2007-05,Connecticut,2169,1794,3963,3574097
2007-05,Delaware,490,542,1032,897934
2007-05,District of Columbia,5,39,44,601723
2007-05,Florida,19701,11298,30999,18801310
2007-05,Georgia,6106,4763,10869,9687653
2007-05,Idaho,1613,2857,4470,1567582
2007-05,Illinois,5105,5224,10329,12830632
2007-05,Indiana,5314,5272,10586,6483802
2007-05,Iowa,18,1563,1581,3046355
2007-05,Kansas,2936,2762,5698,2853118
2007-05,Kentucky,5490,5081,10571,4339367
2007-05,Louisiana,5548,4173,9721,4533372
2007-05,Maine,1125,1687,2812,1328361
2007-05,Maryland,1822,2400,4222,5773552
2007-05,Massachusetts,1794,1071,2865,6547629
2007-05,Michigan,1971,7253,9224,9883640
2007-05,Minnesota,3419,5615,9034,5303925
2007-05,Mississippi,3499,3184,6683,2967297
2007-05,Missouri,5074,7273,12347,5988927
2007-05,Montana,1547,3489,5036,989415
2007-05,Nebraska,0,1225,1225,1826341
2007-05,Nevada,2467,1779,4246,2700551
2007-05,New Hampshire,1499,1563,3062,1316470
2007-05,New Jersey,1447,1154,2601,8791894
2007-05,New Mexico,2755,2594,5349,2059179
2007-05,New York,3239,7596,10835,19378102
2007-05,North Carolina,192,6583,6775,9535483
2007-05,North Dakota,471,1609,2080,672591
2007-05,Ohio,9327,11055,20382,11536504
2007-05,Oklahoma,5403,4657,10060,3751351
2007-05,Oregon,4653,6568,11221,3831074
2007-05,Pennsylvania,0,38683,38683,12702379
2007-05,Rhode Island,403,326,729,1052567
2007-05,South Carolina,3555,2549,6104,4625364
2007-05,South Dakota,761,1896,2657,814180
2007-05,Tennessee,8271,5531,13802,6346105
2007-05,Texas,18914,18183,37097,25145561
2007-05,Utah,2336,3241,5577,2763885
2007-05,Vermont,544,778,1322,625741
2007-05,Virginia,8205,6515,14720,8001024
2007-05,Washington,6377,6057,12434,6724540
2007-05,West Virginia,2587,3204,5791,1852994
2007-05,Wisconsin,3105,6804,9909,5686986
2007-05,Wyoming,910,1560,2470,563626
2007-04,Alabama,7134,5365,12499,4779736
2007-04,Arizona,6761,4831,11592,6392017
2007-04,Arkansas,3171,3846,7017,2915918
2007-04,California,16829,14586,31415,37253956
2007-04,Colorado,6956,7790,14746,5029196
2007-04,Connecticut,2447,2137,4584,3574097
2007-04,Delaware,551,615,1166,897934
2007-04,District of Columbia,2,0,2,601723
2007-04,Florida,19755,10901,30656,18801310
2007-04,Georgia,6455,5343,11798,9687653
2007-04,Idaho,1746,3170,4916,1567582
2007-04,Illinois,5479,6121,11600,12830632
2007-04,Indiana,6040,6608,12648,6483802
2007-04,Iowa,22,2594,2616,3046355
2007-04,Kansas,3367,3743,7110,2853118
2007-04,Kentucky,5906,6941,12847,4339367
2007-04,Louisiana,5920,4300,10220,4533372
2007-04,Maine,1399,2151,3550,1328361
2007-04,Maryland,2059,3040,5099,5773552
2007-04,Massachusetts,2026,1316,3342,6547629
2007-04,Michigan,2220,9885,12105,9883640
2007-04,Minnesota,4365,9169,13534,5303925
2007-04,Mississippi,3842,3452,7294,2967297
2007-04,Missouri,5239,9439,14678,5988927
2007-04,Montana,1692,3920,5612,989415
2007-04,Nebraska,2,1576,1578,1826341
2007-04,Nevada,2358,1955,4313,2700551
2007-04,New Hampshire,1730,2156,3886,1316470
2007-04,New Jersey,1411,1260,2671,8791894
2007-04,New Mexico,2741,3039,5780,2059179
2007-04,New York,3665,10252,13917,19378102
2007-04,North Carolina,206,7259,7465,9535483
2007-04,North Dakota,633,2087,2720,672591
2007-04,Ohio,11287,12819,24106,11536504
2007-04,Oklahoma,5906,5761,11667,3751351
2007-04,Oregon,5400,7923,13323,3831074
2007-04,Pennsylvania,0,44995,44995,12702379
2007-04,Rhode Island,432,391,823,1052567
2007-04,South Carolina,3963,2926,6889,4625364
2007-04,South Dakota,952,2358,3310,814180
2007-04,Tennessee,8611,6549,15160,6346105
2007-04,Texas,18442,18727,37169,25145561
2007-04,Utah,2612,3644,6256,2763885
2007-04,Vermont,612,1099,1711,625741
2007-04,Virginia,8849,7696,16545,8001024
2007-04,Washington,6556,7098,13654,6724540
2007-04,West Virginia,2971,4246,7217,1852994
2007-04,Wisconsin,4193,10879,15072,5686986
2007-04,Wyoming,943,1754,2697,563626
2007-03,Alabama,8378,7867,16245,4779736
2007-03,Arizona,6896,5391,12287,6392017
2007-03,Arkansas,3790,5122,8912,2915918
2007-03,California,18728,16354,35082,37253956
2007-03,Colorado,8012,9579,17591,5029196
2007-03,Connecticut,3024,2484,5508,3574097
2007-03,Delaware,663,726,1389,897934
2007-03,District of Columbia,3,1,4,601723
2007-03,Florida,21650,13835,35485,18801310
2007-03,Georgia,7791,8108,15899,9687653
2007-03,Idaho,1946,3893,5839,1567582
2007-03,Illinois,6468,8451,14919,12830632
2007-03,Indiana,7985,9314,17299,6483802
2007-03,Iowa,32,3991,4023,3046355
2007-03,Kansas,4833,5203,10036,2853118
2007-03,Kentucky,7530,8896,16426,4339367
2007-03,Louisiana,7147,5953,13100,4533372
2007-03,Maine,1539,2411,3950,1328361
2007-03,Maryland,2153,3797,5950,5773552
2007-03,Massachusetts,2478,1639,4117,6547629
2007-03,Michigan,2603,12820,15423,9883640
2007-03,Minnesota,5069,10930,15999,5303925
2007-03,Mississippi,4703,4999,9702,2967297
2007-03,Missouri,5863,12178,18041,5988927
2007-03,Montana,1774,4014,5788,989415
2007-03,Nebraska,0,2224,2224,1826341
2007-03,Nevada,3001,2316,5317,2700551
2007-03,New Hampshire,1788,2163,3951,1316470
2007-03,New Jersey,1652,1666,3318,8791894
2007-03,New Mexico,3171,3542,6713,2059179
2007-03,New York,4058,10401,14459,19378102
2007-03,North Carolina,236,9953,10189,9535483
2007-03,North Dakota,680,2130,2810,672591
2007-03,Ohio,13428,15898,29326,11536504
2007-03,Oklahoma,6651,7449,14100,3751351
2007-03,Oregon,5962,9055,15017,3831074
2007-03,Pennsylvania,0,54723,54723,12702379
2007-03,Rhode Island,461,451,912,1052567
2007-03,South Carolina,4383,4483,8866,4625364
2007-03,South Dakota,1061,2881,3942,814180
2007-03,Tennessee,9883,9391,19274,6346105
2007-03,Texas,21289,23174,44463,25145561
2007-03,Utah,2983,4394,7377,2763885
2007-03,Vermont,698,1211,1909,625741
2007-03,Virginia,10761,9996,20757,8001024
2007-03,Washington,7440,8206,15646,6724540
2007-03,West Virginia,3719,5213,8932,1852994
2007-03,Wisconsin,4636,15150,19786,5686986
2007-03,Wyoming,1059,1936,2995,563626
2007-02,Alabama,9284,8854,18138,4779736
2007-02,Arizona,7662,5981,13643,6392017
2007-02,Arkansas,4565,6099,10664,2915918
2007-02,California,16612,15545,32157,37253956
2007-02,Colorado,7007,8656,15663,5029196
2007-02,Connecticut,2451,1999,4450,3574097
2007-02,Delaware,607,672,1279,897934
2007-02,District of Columbia,1,0,1,601723
2007-02,Florida,20935,13846,34781,18801310
2007-02,Georgia,8790,9102,17892,9687653
2007-02,Idaho,1955,3478,5433,1567582
2007-02,Illinois,5761,7438,13199,12830632
2007-02,Indiana,6721,7720,14441,6483802
2007-02,Iowa,25,3221,3246,3046355
2007-02,Kansas,4173,4750,8923,2853118
2007-02,Kentucky,8232,9362,17594,4339367
2007-02,Louisiana,7019,6344,13363,4533372
2007-02,Maine,1148,1909,3057,1328361
2007-02,Maryland,2022,3789,5811,5773552
2007-02,Massachusetts,1941,1302,3243,6547629
2007-02,Michigan,2364,10746,13110,9883640
2007-02,Minnesota,3961,7430,11391,5303925
2007-02,Mississippi,5506,6242,11748,2967297
2007-02,Missouri,5179,11560,16739,5988927
2007-02,Montana,1471,3084,4555,989415
2007-02,Nebraska,1,1936,1937,1826341
2007-02,Nevada,2556,2066,4622,2700551
2007-02,New Hampshire,1546,1779,3325,1316470
2007-02,New Jersey,1440,1421,2861,8791894
2007-02,New Mexico,3115,3683,6798,2059179
2007-02,New York,3345,9094,12439,19378102
2007-02,North Carolina,343,11268,11611,9535483
2007-02,North Dakota,677,1692,2369,672591
2007-02,Ohio,11980,12876,24856,11536504
2007-02,Oklahoma,6844,7614,14458,3751351
2007-02,Oregon,5260,7968,13228,3831074
2007-02,Pennsylvania,0,43052,43052,12702379
2007-02,Rhode Island,418,381,799,1052567
2007-02,South Carolina,5428,4683,10111,4625364
2007-02,South Dakota,936,2449,3385,814180
2007-02,Tennessee,11804,10234,22038,6346105
2007-02,Texas,21950,24176,46126,25145561
2007-02,Utah,2639,4422,7061,2763885
2007-02,Vermont,686,1052,1738,625741
2007-02,Virginia,9190,9349,18539,8001024
2007-02,Washington,7219,7432,14651,6724540
2007-02,West Virginia,3417,4803,8220,1852994
2007-02,Wisconsin,4385,10595,14980,5686986
2007-02,Wyoming,1029,1756,2785,563626
2007-01,Alabama,8823,9530,18353,4779736
2007-01,Arizona,6247,5546,11793,6392017
2007-01,Arkansas,3705,6022,9727,2915918
2007-01,California,16192,15675,31867,37253956
2007-01,Colorado,6499,8243,14742,5029196
2007-01,Connecticut,2377,2227,4604,3574097
2007-01,Delaware,599,753,1352,897934
2007-01,District of Columbia,4,67,71,601723
2007-01,Florida,19482,13887,33369,18801310
2007-01,Georgia,7492,8789,16281,9687653
2007-01,Idaho,1420,2859,4279,1567582
2007-01,Illinois,5198,7155,12353,12830632
2007-01,Indiana,6961,8305,15266,6483802
2007-01,Iowa,13,3088,3101,3046355
2007-01,Kansas,3425,4662,8087,2853118
2007-01,Kentucky,7030,9046,16076,4339367
2007-01,Louisiana,6834,7560,14394,4533372
2007-01,Maine,1196,2080,3276,1328361
2007-01,Maryland,1868,3451,5319,5773552
2007-01,Massachusetts,1927,1489,3416,6547629
2007-01,Michigan,2312,10327,12639,9883640
2007-01,Minnesota,3875,7140,11015,5303925
2007-01,Mississippi,4441,7065,11506,2967297
2007-01,Missouri,4634,9835,14469,5988927
2007-01,Montana,1259,2634,3893,989415
2007-01,Nebraska,3,1990,1993,1826341
2007-01,Nevada,2395,2057,4452,2700551
2007-01,New Hampshire,1688,1928,3616,1316470
2007-01,New Jersey,1317,1534,2851,8791894
2007-01,New Mexico,2618,3372,5990,2059179
2007-01,New York,3752,9711,13463,19378102
2007-01,North Carolina,260,11175,11435,9535483
2007-01,North Dakota,581,1954,2535,672591
2007-01,Ohio,11141,13703,24844,11536504
2007-01,Oklahoma,4753,6433,11186,3751351
2007-01,Oregon,4841,6939,11780,3831074
2007-01,Pennsylvania,1,45225,45226,12702379
2007-01,Rhode Island,426,372,798,1052567
2007-01,South Carolina,4503,4682,9185,4625364
2007-01,South Dakota,830,2466,3296,814180
2007-01,Tennessee,10320,9792,20112,6346105
2007-01,Texas,19624,25320,44944,25145561
2007-01,Utah,2111,4170,6281,2763885
2007-01,Vermont,532,734,1266,625741
2007-01,Virginia,9031,10055,19086,8001024
2007-01,Washington,6347,6619,12966,6724540
2007-01,West Virginia,3061,4519,7580,1852994
2007-01,Wisconsin,3732,8895,12627,5686986
2007-01,Wyoming,836,1569,2405,563626
2006-12,Alabama,10029,26008,36037,4779736
2006-12,Arizona,8353,11033,19386,6392017
2006-12,Arkansas,4377,15462,19839,2915918
2006-12,California,16275,20903,37178,37253956
2006-12,Colorado,7652,14388,22040,5029196
2006-12,Connecticut,2684,3053,5737,3574097
2006-12,Delaware,677,1702,2379,897934
2006-12,District of Columbia,7,1,8,601723
2006-12,Florida,21311,27946,49257,18801310
2006-12,Georgia,9468,25683,35151,9687653
2006-12,Idaho,2055,6662,8717,1567582
2006-12,Illinois,5986,12279,18265,12830632
2006-12,Indiana,7138,16146,23284,6483802
2006-12,Iowa,34,7691,7725,3046355
2006-12,Kansas,4271,10401,14672,2853118
2006-12,Kentucky,9337,20330,29667,4339367
2006-12,Louisiana,7841,21390,29231,4533372
2006-12,Maine,1397,3845,5242,1328361
2006-12,Maryland,1319,7167,8486,5773552
2006-12,Massachusetts,1974,1884,3858,6547629
2006-12,Michigan,2460,21246,23706,9883640
2006-12,Minnesota,4246,13559,17805,5303925
2006-12,Mississippi,5226,20475,25701,2967297
2006-12,Missouri,5278,22173,27451,5988927
2006-12,Montana,1946,5611,7557,989415
2006-12,Nebraska,1,5151,5152,1826341
2006-12,Nevada,2916,4044,6960,2700551
2006-12,New Hampshire,1794,3003,4797,1316470
2006-12,New Jersey,1367,2646,4013,8791894
2006-12,New Mexico,3193,6136,9329,2059179
2006-12,New York,3263,17617,20880,19378102
2006-12,North Carolina,297,27037,27334,9535483
2006-12,North Dakota,620,2966,3586,672591
2006-12,Ohio,13640,25108,38748,11536504
2006-12,Oklahoma,7004,15609,22613,3751351
2006-12,Oregon,5912,13698,19610,3831074
2006-12,Pennsylvania,0,59214,59214,12702379
2006-12,Rhode Island,396,554,950,1052567
2006-12,South Carolina,5159,12689,17848,4625364
2006-12,South Dakota,975,4718,5693,814180
2006-12,Tennessee,12069,22723,34792,6346105
2006-12,Texas,24939,61903,86842,25145561
2006-12,Utah,3345,11500,14845,2763885
2006-12,Vermont,648,1525,2173,625741
2006-12,Virginia,10114,20790,30904,8001024
2006-12,Washington,6759,12298,19057,6724540
2006-12,West Virginia,4130,11781,15911,1852994
2006-12,Wisconsin,4648,14981,19629,5686986
2006-12,Wyoming,1296,3415,4711,563626
2006-11,Alabama,6915,17468,24383,4779736
2006-11,Arizona,5504,6900,12404,6392017
2006-11,Arkansas,2921,13227,16148,2915918
2006-11,California,14872,18247,33119,37253956
2006-11,Colorado,6956,11631,18587,5029196
2006-11,Connecticut,2154,2819,4973,3574097
2006-11,Delaware,532,1452,1984,897934
2006-11,District of Columbia,3,0,3,601723
2006-11,Florida,18006,20716,38722,18801310
2006-11,Georgia,5846,15499,21345,9687653
2006-11,Idaho,1412,4181,5593,1567582
2006-11,Illinois,4948,11771,16719,12830632
2006-11,Indiana,6058,14668,20726,6483802
2006-11,Iowa,20,7141,7161,3046355
2006-11,Kansas,3013,8225,11238,2853118
2006-11,Kentucky,5989,15104,21093,4339367
2006-11,Louisiana,5276,15132,20408,4533372
2006-11,Maine,1112,3832,4944,1328361
2006-11,Maryland,1439,6894,8333,5773552
2006-11,Massachusetts,1701,2010,3711,6547629
2006-11,Michigan,1915,21089,23004,9883640
2006-11,Minnesota,2777,12690,15467,5303925
2006-11,Mississippi,3551,17282,20833,2967297
2006-11,Missouri,3864,16706,20570,5988927
2006-11,Montana,1104,3852,4956,989415
2006-11,Nebraska,2,4555,4557,1826341
2006-11,Nevada,2128,2736,4864,2700551
2006-11,New Hampshire,1568,2810,4378,1316470
2006-11,New Jersey,1239,2545,3784,8791894
2006-11,New Mexico,2390,3921,6311,2059179
2006-11,New York,2968,16692,19660,19378102
2006-11,North Carolina,216,18925,19141,9535483
2006-11,North Dakota,462,3205,3667,672591
2006-11,Ohio,9911,24610,34521,11536504
2006-11,Oklahoma,4373,11003,15376,3751351
2006-11,Oregon,4793,9110,13903,3831074
2006-11,Pennsylvania,0,56099,56099,12702379
2006-11,Rhode Island,352,477,829,1052567
2006-11,South Carolina,3886,8933,12819,4625364
2006-11,South Dakota,654,4778,5432,814180
2006-11,Tennessee,8585,16389,24974,6346105
2006-11,Texas,16689,39310,55999,25145561
2006-11,Utah,2185,6686,8871,2763885
2006-11,Vermont,448,1684,2132,625741
2006-11,Virginia,7924,17557,25481,8001024
2006-11,Washington,5817,8532,14349,6724540
2006-11,West Virginia,2604,10779,13383,1852994
2006-11,Wisconsin,3577,17465,21042,5686986
2006-11,Wyoming,861,2252,3113,563626
2006-10,Alabama,6174,10714,16888,4779736
2006-10,Arizona,5692,6462,12154,6392017
2006-10,Arkansas,2782,9554,12336,2915918
2006-10,California,15251,15914,31165,37253956
2006-10,Colorado,6423,11316,17739,5029196
2006-10,Connecticut,2359,2528,4887,3574097
2006-10,Delaware,483,1078,1561,897934
2006-10,District of Columbia,2,0,2,601723
2006-10,Florida,17970,15942,33912,18801310
2006-10,Georgia,5989,12437,18426,9687653
2006-10,Idaho,1490,5038,6528,1567582
2006-10,Illinois,5323,9732,15055,12830632
2006-10,Indiana,5470,9964,15434,6483802
2006-10,Iowa,24,5694,5718,3046355
2006-10,Kansas,3206,6587,9793,2853118
2006-10,Kentucky,5840,12191,18031,4339367
2006-10,Louisiana,5830,13067,18897,4533372
2006-10,Maine,1332,5896,7228,1328361
2006-10,Maryland,1125,5200,6325,5773552
2006-10,Massachusetts,1693,1690,3383,6547629
2006-10,Michigan,2035,17772,19807,9883640
2006-10,Minnesota,3330,19500,22830,5303925
2006-10,Mississippi,3228,9702,12930,2967297
2006-10,Missouri,4021,16249,20270,5988927
2006-10,Montana,1469,6228,7697,989415
2006-10,Nebraska,1,3597,3598,1826341
2006-10,Nevada,2294,2382,4676,2700551
2006-10,New Hampshire,1514,3237,4751,1316470
2006-10,New Jersey,1319,1936,3255,8791894
2006-10,New Mexico,2502,3758,6260,2059179
2006-10,New York,3241,15579,18820,19378102
2006-10,North Carolina,221,13996,14217,9535483
2006-10,North Dakota,461,4374,4835,672591
2006-10,Ohio,9485,15865,25350,11536504
2006-10,Oklahoma,4803,9211,14014,3751351
2006-10,Oregon,4271,8203,12474,3831074
2006-10,Pennsylvania,0,49226,49226,12702379
2006-10,Rhode Island,343,424,767,1052567
2006-10,South Carolina,3517,6273,9790,4625364
2006-10,South Dakota,650,6073,6723,814180
2006-10,Tennessee,7905,11692,19597,6346105
2006-10,Texas,16442,34162,50604,25145561
2006-10,Utah,1804,5376,7180,2763885
2006-10,Vermont,554,1748,2302,625741
2006-10,Virginia,7436,12437,19873,8001024
2006-10,Washington,6031,9600,15631,6724540
2006-10,West Virginia,2569,8331,10900,1852994
2006-10,Wisconsin,3949,18096,22045,5686986
2006-10,Wyoming,818,2340,3158,563626
2006-09,Alabama,6257,10357,16614,4779736
2006-09,Arizona,6370,6862,13232,6392017
2006-09,Arkansas,2843,8243,11086,2915918
2006-09,California,13433,16155,29588,37253956
2006-09,Colorado,6317,10823,17140,5029196
2006-09,Connecticut,1868,2013,3881,3574097
2006-09,Delaware,431,914,1345,897934
2006-09,District of Columbia,1,0,1,601723
2006-09,Florida,16596,13698,30294,18801310
2006-09,Georgia,5795,9661,15456,9687653
2006-09,Idaho,1706,5209,6915,1567582
2006-09,Illinois,4607,8118,12725,12830632
2006-09,Indiana,5381,8879,14260,6483802
2006-09,Iowa,11,4437,4448,3046355
2006-09,Kansas,2809,5754,8563,2853118
2006-09,Kentucky,5672,9943,15615,4339367
2006-09,Louisiana,5948,10836,16784,4533372
2006-09,Maine,1287,4128,5415,1328361
2006-09,Maryland,419,4374,4793,5773552
2006-09,Massachusetts,1654,1452,3106,6547629
2006-09,Michigan,2018,17506,19524,9883640
2006-09,Minnesota,3591,18315,21906,5303925
2006-09,Mississippi,3239,8493,11732,2967297
2006-09,Missouri,3967,12497,16464,5988927
2006-09,Montana,1536,5283,6819,989415
2006-09,Nebraska,0,2752,2752,1826341
2006-09,Nevada,2059,2339,4398,2700551
2006-09,New Hampshire,1474,2862,4336,1316470
2006-09,New Jersey,1164,1640,2804,8791894
2006-09,New Mexico,2352,3608,5960,2059179
2006-09,New York,3223,14603,17826,19378102
2006-09,North Carolina,200,11797,11997,9535483
2006-09,North Dakota,482,3491,3973,672591
2006-09,Ohio,8680,15186,23866,11536504
2006-09,Oklahoma,4360,8089,12449,3751351
2006-09,Oregon,4775,10813,15588,3831074
2006-09,Pennsylvania,0,46215,46215,12702379
2006-09,Rhode Island,336,415,751,1052567
2006-09,South Carolina,3407,5773,9180,4625364
2006-09,South Dakota,734,4609,5343,814180
2006-09,Tennessee,7359,10123,17482,6346105
2006-09,Texas,16362,37821,54183,25145561
2006-09,Utah,1955,5749,7704,2763885
2006-09,Vermont,584,1536,2120,625741
2006-09,Virginia,6935,11023,17958,8001024
2006-09,Washington,5446,9061,14507,6724540
2006-09,West Virginia,2606,6987,9593,1852994
2006-09,Wisconsin,3800,16212,20012,5686986
2006-09,Wyoming,984,2440,3424,563626
2006-08,Alabama,6334,7611,13945,4779736
2006-08,Arizona,6608,7017,13625,6392017
2006-08,Arkansas,2702,5880,8582,2915918
2006-08,California,15372,17540,32912,37253956
2006-08,Colorado,7185,10058,17243,5029196
2006-08,Connecticut,1805,1693,3498,3574097
2006-08,Delaware,436,676,1112,897934
2006-08,District of Columbia,5,1,6,601723
2006-08,Florida,17575,12997,30572,18801310
2006-08,Georgia,6149,8495,14644,9687653
2006-08,Idaho,1447,3526,4973,1567582
2006-08,Illinois,4685,7899,12584,12830632
2006-08,Indiana,5462,7715,13177,6483802
2006-08,Iowa,13,2599,2612,3046355
2006-08,Kansas,2746,4302,7048,2853118
2006-08,Kentucky,5393,8078,13471,4339367
2006-08,Louisiana,5790,8809,14599,4533372
2006-08,Maine,1139,2615,3754,1328361
2006-08,Maryland,584,3641,4225,5773552
2006-08,Massachusetts,1711,1203,2914,6547629
2006-08,Michigan,1966,11502,13468,9883640
2006-08,Minnesota,3046,11091,14137,5303925
2006-08,Mississippi,3762,7358,11120,2967297
2006-08,Missouri,4077,11503,15580,5988927
2006-08,Montana,1558,3828,5386,989415
2006-08,Nebraska,0,1867,1867,1826341
2006-08,Nevada,2707,2393,5100,2700551
2006-08,New Hampshire,1254,2015,3269,1316470
2006-08,New Jersey,1233,1457,2690,8791894
2006-08,New Mexico,2683,3436,6119,2059179
2006-08,New York,2903,8838,11741,19378102
2006-08,North Carolina,211,10673,10884,9535483
2006-08,North Dakota,501,2498,2999,672591
2006-08,Ohio,8101,12024,20125,11536504
2006-08,Oklahoma,4679,7375,12054,3751351
2006-08,Oregon,4456,7358,11814,3831074
2006-08,Pennsylvania,0,37895,37895,12702379
2006-08,Rhode Island,310,307,617,1052567
2006-08,South Carolina,3332,5097,8429,4625364
2006-08,South Dakota,687,2848,3535,814180
2006-08,Tennessee,7739,10097,17836,6346105
2006-08,Texas,16160,32850,49010,25145561
2006-08,Utah,1728,4011,5739,2763885
2006-08,Vermont,493,900,1393,625741
2006-08,Virginia,6994,8918,15912,8001024
2006-08,Washington,5750,7484,13234,6724540
2006-08,West Virginia,2323,4006,6329,1852994
2006-08,Wisconsin,3084,9857,12941,5686986
2006-08,Wyoming,821,1948,2769,563626
2006-07,Alabama,5798,5480,11278,4779736
2006-07,Arizona,6342,5210,11552,6392017
2006-07,Arkansas,2567,3862,6429,2915918
2006-07,California,13783,14215,27998,37253956
2006-07,Colorado,5931,7540,13471,5029196
2006-07,Connecticut,1678,1481,3159,3574097
2006-07,Delaware,416,458,874,897934
2006-07,District of Columbia,0,0,0,601723
2006-07,Florida,16011,10415,26426,18801310
2006-07,Georgia,5659,5916,11575,9687653
2006-07,Idaho,1273,2459,3732,1567582
2006-07,Illinois,4148,5600,9748,12830632
2006-07,Indiana,4472,5443,9915,6483802
2006-07,Iowa,16,1733,1749,3046355
2006-07,Kansas,2332,2909,5241,2853118
2006-07,Kentucky,4945,5817,10762,4339367
2006-07,Louisiana,6136,5664,11800,4533372
2006-07,Maine,932,1705,2637,1328361
2006-07,Maryland,440,2568,3008,5773552
2006-07,Massachusetts,1336,925,2261,6547629
2006-07,Michigan,1853,7536,9389,9883640
2006-07,Minnesota,2694,6951,9645,5303925
2006-07,Mississippi,3427,4343,7770,2967297
2006-07,Missouri,3403,7246,10649,5988927
2006-07,Montana,1246,2910,4156,989415
2006-07,Nebraska,0,1270,1270,1826341
2006-07,Nevada,2147,1853,4000,2700551
2006-07,New Hampshire,1056,1535,2591,1316470
2006-07,New Jersey,1261,1051,2312,8791894
2006-07,New Mexico,2179,2593,4772,2059179
2006-07,New York,2667,6554,9221,19378102
2006-07,North Carolina,180,6981,7161,9535483
2006-07,North Dakota,424,1577,2001,672591
2006-07,Ohio,7293,9630,16923,11536504
2006-07,Oklahoma,4070,4865,8935,3751351
2006-07,Oregon,3993,6043,10036,3831074
2006-07,Pennsylvania,0,31212,31212,12702379
2006-07,Rhode Island,288,269,557,1052567
2006-07,South Carolina,3394,3186,6580,4625364
2006-07,South Dakota,556,2037,2593,814180
2006-07,Tennessee,6785,6452,13237,6346105
2006-07,Texas,15063,20324,35387,25145561
2006-07,Utah,1751,3096,4847,2763885
2006-07,Vermont,407,593,1000,625741
2006-07,Virginia,7764,7647,15411,8001024
2006-07,Washington,5006,5785,10791,6724540
2006-07,West Virginia,2114,3487,5601,1852994
2006-07,Wisconsin,2669,6244,8913,5686986
2006-07,Wyoming,677,1485,2162,563626
2006-06,Alabama,6060,5143,11203,4779736
2006-06,Arizona,5167,4663,9830,6392017
2006-06,Arkansas,2551,3547,6098,2915918
2006-06,California,14262,13796,28058,37253956
2006-06,Colorado,6169,7137,13306,5029196
2006-06,Connecticut,1962,1734,3696,3574097
2006-06,Delaware,428,568,996,897934
2006-06,District of Columbia,5,0,5,601723
2006-06,Florida,16766,10790,27556,18801310
2006-06,Georgia,9016,7494,16510,9687653
2006-06,Idaho,1404,2775,4179,1567582
2006-06,Illinois,4169,5011,9180,12830632
2006-06,Indiana,4867,5566,10433,6483802
2006-06,Iowa,13,1775,1788,3046355
2006-06,Kansas,2150,2858,5008,2853118
2006-06,Kentucky,5389,5843,11232,4339367
2006-06,Louisiana,6190,4933,11123,4533372
2006-06,Maine,1021,1751,2772,1328361
2006-06,Maryland,440,2707,3147,5773552
2006-06,Massachusetts,1646,1065,2711,6547629
2006-06,Michigan,1906,7473,9379,9883640
2006-06,Minnesota,2839,5848,8687,5303925
2006-06,Mississippi,3407,3731,7138,2967297
2006-06,Missouri,3659,7056,10715,5988927
2006-06,Montana,1383,3343,4726,989415
2006-06,Nebraska,2,1257,1259,1826341
2006-06,Nevada,2023,1867,3890,2700551
2006-06,New Hampshire,1114,1635,2749,1316470
2006-06,New Jersey,1479,1286,2765,8791894
2006-06,New Mexico,2319,2724,5043,2059179
2006-06,New York,3039,7049,10088,19378102
2006-06,North Carolina,197,7016,7213,9535483
2006-06,North Dakota,459,1505,1964,672591
2006-06,Ohio,7862,10911,18773,11536504
2006-06,Oklahoma,4499,4867,9366,3751351
2006-06,Oregon,4371,6972,11343,3831074
2006-06,Pennsylvania,1,32925,32926,12702379
2006-06,Rhode Island,305,284,589,1052567
2006-06,South Carolina,3267,2792,6059,4625364
2006-06,South Dakota,610,1903,2513,814180
2006-06,Tennessee,7038,6019,13057,6346105
2006-06,Texas,15169,19334,34503,25145561
2006-06,Utah,1826,3494,5320,2763885
2006-06,Vermont,538,639,1177,625741
2006-06,Virginia,8607,7444,16051,8001024
2006-06,Washington,5570,6745,12315,6724540
2006-06,West Virginia,2390,3350,5740,1852994
2006-06,Wisconsin,2765,6080,8845,5686986
2006-06,Wyoming,861,1495,2356,563626
2006-05,Alabama,5733,5129,10862,4779736
2006-05,Arizona,5663,4746,10409,6392017
2006-05,Arkansas,2598,3634,6232,2915918
2006-05,California,14965,16125,31090,37253956
2006-05,Colorado,6011,7446,13457,5029196
2006-05,Connecticut,1846,1657,3503,3574097
2006-05,Delaware,503,601,1104,897934
2006-05,District of Columbia,1,0,1,601723
2006-05,Florida,16822,10891,27713,18801310
2006-05,Georgia,8661,7419,16080,9687653
2006-05,Idaho,1356,2963,4319,1567582
2006-05,Illinois,4622,5545,10167,12830632
2006-05,Indiana,4787,5350,10137,6483802
2006-05,Iowa,19,1769,1788,3046355
2006-05,Kansas,2370,3069,5439,2853118
2006-05,Kentucky,5315,5933,11248,4339367
2006-05,Louisiana,5627,4411,10038,4533372
2006-05,Maine,970,1829,2799,1328361
2006-05,Maryland,636,2621,3257,5773552
2006-05,Massachusetts,1589,970,2559,6547629
2006-05,Michigan,2203,8408,10611,9883640
2006-05,Minnesota,2969,6081,9050,5303925
2006-05,Mississippi,3453,3668,7121,2967297
2006-05,Missouri,3733,7601,11334,5988927
2006-05,Montana,1346,3447,4793,989415
2006-05,Nebraska,1,1314,1315,1826341
2006-05,Nevada,2092,1948,4040,2700551
2006-05,New Hampshire,1095,1699,2794,1316470
2006-05,New Jersey,1511,1291,2802,8791894
2006-05,New Mexico,2228,2601,4829,2059179
2006-05,New York,2656,7338,9994,19378102
2006-05,North Carolina,203,6839,7042,9535483
2006-05,North Dakota,399,1435,1834,672591
2006-05,Ohio,8846,10854,19700,11536504
2006-05,Oklahoma,4373,4954,9327,3751351
2006-05,Oregon,4068,6994,11062,3831074
2006-05,Pennsylvania,0,34195,34195,12702379
2006-05,Rhode Island,378,314,692,1052567
2006-05,South Carolina,2981,2689,5670,4625364
2006-05,South Dakota,618,1802,2420,814180
2006-05,Tennessee,6963,5813,12776,6346105
2006-05,Texas,14920,18993,33913,25145561
2006-05,Utah,1698,3434,5132,2763885
2006-05,Vermont,485,759,1244,625741
2006-05,Virginia,7810,6826,14636,8001024
2006-05,Washington,5515,6733,12248,6724540
2006-05,West Virginia,2365,3502,5867,1852994
2006-05,Wisconsin,3099,7089,10188,5686986
2006-05,Wyoming,802,1566,2368,563626
2006-04,Alabama,5757,5522,11279,4779736
2006-04,Arizona,6946,5753,12699,6392017
2006-04,Arkansas,2698,4474,7172,2915918
2006-04,California,20942,21348,42290,37253956
2006-04,Colorado,6345,8336,14681,5029196
2006-04,Connecticut,2060,2077,4137,3574097
2006-04,Delaware,469,595,1064,897934
2006-04,District of Columbia,5,0,5,601723
2006-04,Florida,16904,11827,28731,18801310
2006-04,Georgia,8669,8341,17010,9687653
2006-04,Idaho,1369,3464,4833,1567582
2006-04,Illinois,4384,6164,10548,12830632
2006-04,Indiana,5012,6804,11816,6483802
2006-04,Iowa,15,2899,2914,3046355
2006-04,Kansas,2438,3803,6241,2853118
2006-04,Kentucky,5222,7935,13157,4339367
2006-04,Louisiana,5916,4637,10553,4533372
2006-04,Maine,1155,2372,3527,1328361
2006-04,Maryland,610,3244,3854,5773552
2006-04,Massachusetts,1946,1369,3315,6547629
2006-04,Michigan,2533,10709,13242,9883640
2006-04,Minnesota,3730,10017,13747,5303925
2006-04,Mississippi,3696,4053,7749,2967297
2006-04,Missouri,4150,10031,14181,5988927
2006-04,Montana,1514,3836,5350,989415
2006-04,Nebraska,0,1656,1656,1826341
2006-04,Nevada,2292,2311,4603,2700551
2006-04,New Hampshire,1390,2240,3630,1316470
2006-04,New Jersey,1468,1485,2953,8791894
2006-04,New Mexico,2415,3256,5671,2059179
2006-04,New York,986,8615,9601,19378102
2006-04,North Carolina,173,7861,8034,9535483
2006-04,North Dakota,505,1739,2244,672591
2006-04,Ohio,9660,12692,22352,11536504
2006-04,Oklahoma,4920,6332,11252,3751351
2006-04,Oregon,4796,8954,13750,3831074
2006-04,Pennsylvania,0,38480,38480,12702379
2006-04,Rhode Island,349,338,687,1052567
2006-04,South Carolina,3199,3238,6437,4625364
2006-04,South Dakota,785,2427,3212,814180
2006-04,Tennessee,6854,6812,13666,6346105
2006-04,Texas,15551,20402,35953,25145561
2006-04,Utah,1979,3857,5836,2763885
2006-04,Vermont,614,1128,1742,625741
2006-04,Virginia,12148,8794,20942,8001024
2006-04,Washington,5774,7434,13208,6724540
2006-04,West Virginia,2508,4619,7127,1852994
2006-04,Wisconsin,3448,11593,15041,5686986
2006-04,Wyoming,826,1882,2708,563626
2006-03,Alabama,7656,8514,16170,4779736
2006-03,Arizona,7057,6178,13235,6392017
2006-03,Arkansas,3557,6184,9741,2915918
2006-03,California,23195,26317,49512,37253956
2006-03,Colorado,7804,10350,18154,5029196
2006-03,Connecticut,2713,2738,5451,3574097
2006-03,Delaware,597,793,1390,897934
2006-03,District of Columbia,7,0,7,601723
2006-03,Florida,19099,14774,33873,18801310
2006-03,Georgia,11729,12336,24065,9687653
2006-03,Idaho,1559,3728,5287,1567582
2006-03,Illinois,6275,9124,15399,12830632
2006-03,Indiana,7402,9610,17012,6483802
2006-03,Iowa,34,4204,4238,3046355
2006-03,Kansas,3467,5187,8654,2853118
2006-03,Kentucky,7362,9833,17195,4339367
2006-03,Louisiana,7732,6693,14425,4533372
2006-03,Maine,1511,2797,4308,1328361
2006-03,Maryland,738,3951,4689,5773552
2006-03,Massachusetts,2337,1590,3927,6547629
2006-03,Michigan,3547,14094,17641,9883640
2006-03,Minnesota,4567,11286,15853,5303925
2006-03,Mississippi,4796,6139,10935,2967297
2006-03,Missouri,5559,12454,18013,5988927
2006-03,Montana,1616,4100,5716,989415
2006-03,Nebraska,1,2039,2040,1826341
2006-03,Nevada,3051,2794,5845,2700551
2006-03,New Hampshire,1639,2350,3989,1316470
2006-03,New Jersey,1704,1857,3561,8791894
2006-03,New Mexico,3020,3807,6827,2059179
2006-03,New York,1334,8827,10161,19378102
2006-03,North Carolina,270,10832,11102,9535483
2006-03,North Dakota,591,2048,2639,672591
2006-03,Ohio,12873,16625,29498,11536504
2006-03,Oklahoma,5349,7447,12796,3751351
2006-03,Oregon,5663,9612,15275,3831074
2006-03,Pennsylvania,1,50145,50146,12702379
2006-03,Rhode Island,482,439,921,1052567
2006-03,South Carolina,4384,4820,9204,4625364
2006-03,South Dakota,982,2908,3890,814180
2006-03,Tennessee,8915,10125,19040,6346105
2006-03,Texas,18841,24710,43551,25145561
2006-03,Utah,2103,4671,6774,2763885
2006-03,Vermont,732,1335,2067,625741
2006-03,Virginia,9604,10320,19924,8001024
2006-03,Washington,6668,8299,14967,6724540
2006-03,West Virginia,3471,5897,9368,1852994
2006-03,Wisconsin,4362,15105,19467,5686986
2006-03,Wyoming,891,1929,2820,563626
2006-02,Alabama,8517,9318,17835,4779736
2006-02,Arizona,7505,6580,14085,6392017
2006-02,Arkansas,4047,6835,10882,2915918
2006-02,California,19479,23368,42847,37253956
2006-02,Colorado,6710,9322,16032,5029196
2006-02,Connecticut,2333,2202,4535,3574097
2006-02,Delaware,545,765,1310,897934
2006-02,District of Columbia,15,193,208,601723
2006-02,Florida,18880,14471,33351,18801310
2006-02,Georgia,12435,12845,25280,9687653
2006-02,Idaho,1485,3409,4894,1567582
2006-02,Illinois,6072,8148,14220,12830632
2006-02,Indiana,7211,8941,16152,6483802
2006-02,Iowa,25,3403,3428,3046355
2006-02,Kansas,2862,4767,7629,2853118
2006-02,Kentucky,8015,10635,18650,4339367
2006-02,Louisiana,8004,7166,15170,4533372
2006-02,Maine,1286,2353,3639,1328361
2006-02,Maryland,704,4197,4901,5773552
2006-02,Massachusetts,1882,1372,3254,6547629
2006-02,Michigan,3120,12319,15439,9883640
2006-02,Minnesota,3777,8999,12776,5303925
2006-02,Mississippi,5848,6859,12707,2967297
2006-02,Missouri,5262,12131,17393,5988927
2006-02,Montana,1388,3205,4593,989415
2006-02,Nebraska,2,1910,1912,1826341
2006-02,Nevada,2513,2501,5014,2700551
2006-02,New Hampshire,1358,2007,3365,1316470
2006-02,New Jersey,1331,1470,2801,8791894
2006-02,New Mexico,2669,3661,6330,2059179
2006-02,New York,1117,8263,9380,19378102
2006-02,North Carolina,303,11941,12244,9535483
2006-02,North Dakota,488,1760,2248,672591
2006-02,Ohio,12791,14834,27625,11536504
2006-02,Oklahoma,6098,7895,13993,3751351
2006-02,Oregon,4706,8295,13001,3831074
2006-02,Pennsylvania,0,41377,41377,12702379
2006-02,Rhode Island,408,340,748,1052567
2006-02,South Carolina,5052,5015,10067,4625364
2006-02,South Dakota,970,2830,3800,814180
2006-02,Tennessee,9862,10843,20705,6346105
2006-02,Texas,20182,26709,46891,25145561
2006-02,Utah,2015,4643,6658,2763885
2006-02,Vermont,752,1133,1885,625741
2006-02,Virginia,9595,10146,19741,8001024
2006-02,Washington,6135,7744,13879,6724540
2006-02,West Virginia,3286,5543,8829,1852994
2006-02,Wisconsin,4472,11602,16074,5686986
2006-02,Wyoming,825,1779,2604,563626
2006-01,Alabama,7870,9813,17683,4779736
2006-01,Arizona,6256,6108,12364,6392017
2006-01,Arkansas,3528,6563,10091,2915918
2006-01,California,19028,24054,43082,37253956
2006-01,Colorado,5985,9003,14988,5029196
2006-01,Connecticut,2264,2296,4560,3574097
2006-01,Delaware,590,765,1355,897934
2006-01,District of Columbia,3,1,4,601723
2006-01,Florida,17881,15011,32892,18801310
2006-01,Georgia,11545,12846,24391,9687653
2006-01,Idaho,1254,2800,4054,1567582
2006-01,Illinois,5368,8328,13696,12830632
2006-01,Indiana,6625,8443,15068,6483802
2006-01,Iowa,34,3297,3331,3046355
2006-01,Kansas,2821,5456,8277,2853118
2006-01,Kentucky,6755,9274,16029,4339367
2006-01,Louisiana,7859,8520,16379,4533372
2006-01,Maine,1121,2158,3279,1328361
2006-01,Maryland,503,3968,4471,5773552
2006-01,Massachusetts,1872,1358,3230,6547629
2006-01,Michigan,3012,10800,13812,9883640
2006-01,Minnesota,3324,7424,10748,5303925
2006-01,Mississippi,5156,7834,12990,2967297
2006-01,Missouri,4656,11442,16098,5988927
2006-01,Montana,1157,2890,4047,989415
2006-01,Nebraska,1,2221,2222,1826341
2006-01,Nevada,2431,2350,4781,2700551
2006-01,New Hampshire,1239,1895,3134,1316470
2006-01,New Jersey,1284,1647,2931,8791894
2006-01,New Mexico,2337,3207,5544,2059179
2006-01,New York,1483,7719,9202,19378102
2006-01,North Carolina,204,12118,12322,9535483
2006-01,North Dakota,485,1742,2227,672591
2006-01,Ohio,10510,12767,23277,11536504
2006-01,Oklahoma,4834,7594,12428,3751351
2006-01,Oregon,4560,7400,11960,3831074
2006-01,Pennsylvania,1,38777,38778,12702379
2006-01,Rhode Island,368,382,750,1052567
2006-01,South Carolina,4345,5155,9500,4625364
2006-01,South Dakota,886,2596,3482,814180
2006-01,Tennessee,8854,9975,18829,6346105
2006-01,Texas,18788,27781,46569,25145561
2006-01,Utah,1809,4148,5957,2763885
2006-01,Vermont,488,719,1207,625741
2006-01,Virginia,8811,10175,18986,8001024
2006-01,Washington,5807,7018,12825,6724540
2006-01,West Virginia,2842,4936,7778,1852994
2006-01,Wisconsin,3779,8810,12589,5686986
2006-01,Wyoming,807,1708,2515,563626
2005-12,Alabama,9737,28159,37896,4779736
2005-12,Arizona,8093,11311,19404,6392017
2005-12,Arkansas,4338,17520,21858,2915918
2005-12,California,21649,30222,51871,37253956
2005-12,Colorado,7625,15806,23431,5029196
2005-12,Connecticut,2346,2905,5251,3574097
2005-12,Delaware,745,1824,2569,897934
2005-12,District of Columbia,3,0,3,601723
2005-12,Florida,20028,30257,50285,18801310
2005-12,Georgia,13700,32795,46495,9687653
2005-12,Idaho,1843,6201,8044,1567582
2005-12,Illinois,5725,13022,18747,12830632
2005-12,Indiana,6291,15837,22128,6483802
2005-12,Iowa,39,8110,8149,3046355
2005-12,Kansas,2588,10721,13309,2853118
2005-12,Kentucky,8501,21158,29659,4339367
2005-12,Louisiana,9646,25463,35109,4533372
2005-12,Maine,1206,3647,4853,1328361
2005-12,Maryland,622,7817,8439,5773552
2005-12,Massachusetts,1943,1647,3590,6547629
2005-12,Michigan,3015,20350,23365,9883640
2005-12,Minnesota,3440,13141,16581,5303925
2005-12,Mississippi,6267,22351,28618,2967297
2005-12,Missouri,5057,23623,28680,5988927
2005-12,Montana,1690,5624,7314,989415
2005-12,Nebraska,2,5195,5197,1826341
2005-12,Nevada,3607,4860,8467,2700551
2005-12,New Hampshire,1370,2978,4348,1316470
2005-12,New Jersey,1294,2824,4118,8791894
2005-12,New Mexico,2982,5982,8964,2059179
2005-12,New York,1040,14046,15086,19378102
2005-12,North Carolina,242,28579,28821,9535483
2005-12,North Dakota,539,2836,3375,672591
2005-12,Ohio,11928,24515,36443,11536504
2005-12,Oklahoma,6281,17477,23758,3751351
2005-12,Oregon,5588,14095,19683,3831074
2005-12,Pennsylvania,0,49746,49746,12702379
2005-12,Rhode Island,365,505,870,1052567
2005-12,South Carolina,5047,13792,18839,4625364
2005-12,South Dakota,925,4798,5723,814180
2005-12,Tennessee,10811,24155,34966,6346105
2005-12,Texas,23352,67200,90552,25145561
2005-12,Utah,2800,10407,13207,2763885
2005-12,Vermont,483,1377,1860,625741
2005-12,Virginia,9513,21185,30698,8001024
2005-12,Washington,6657,12358,19015,6724540
2005-12,West Virginia,3740,11216,14956,1852994
2005-12,Wisconsin,4082,14332,18414,5686986
2005-12,Wyoming,1159,3317,4476,563626
2005-11,Alabama,6313,17734,24047,4779736
2005-11,Arizona,5327,6816,12143,6392017
2005-11,Arkansas,2613,13209,15822,2915918
2005-11,California,18192,22074,40266,37253956
2005-11,Colorado,6248,12035,18283,5029196
2005-11,Connecticut,1831,2796,4627,3574097
2005-11,Delaware,520,1442,1962,897934
2005-11,District of Columbia,2,0,2,601723
2005-11,Florida,16542,19727,36269,18801310
2005-11,Georgia,8144,17976,26120,9687653
2005-11,Idaho,1191,3707,4898,1567582
2005-11,Illinois,4880,11531,16411,12830632
2005-11,Indiana,4843,13391,18234,6483802
2005-11,Iowa,26,7684,7710,3046355
2005-11,Kansas,2092,9235,11327,2853118
2005-11,Kentucky,5465,15510,20975,4339367
2005-11,Louisiana,6989,17960,24949,4533372
2005-11,Maine,984,3471,4455,1328361
2005-11,Maryland,682,7225,7907,5773552
2005-11,Massachusetts,1559,1707,3266,6547629
2005-11,Michigan,2403,21128,23531,9883640
2005-11,Minnesota,2708,12576,15284,5303925
2005-11,Mississippi,4516,17518,22034,2967297
2005-11,Missouri,3594,18004,21598,5988927
2005-11,Montana,1095,3779,4874,989415
2005-11,Nebraska,1,3957,3958,1826341
2005-11,Nevada,2760,3105,5865,2700551
2005-11,New Hampshire,1224,2757,3981,1316470
2005-11,New Jersey,1305,2469,3774,8791894
2005-11,New Mexico,2165,3809,5974,2059179
2005-11,New York,821,14122,14943,19378102
2005-11,North Carolina,178,18167,18345,9535483
2005-11,North Dakota,373,2680,3053,672591
2005-11,Ohio,9287,23316,32603,11536504
2005-11,Oklahoma,4213,11951,16164,3751351
2005-11,Oregon,4172,9235,13407,3831074
2005-11,Pennsylvania,1,51087,51088,12702379
2005-11,Rhode Island,350,500,850,1052567
2005-11,South Carolina,3700,8201,11901,4625364
2005-11,South Dakota,616,4381,4997,814180
2005-11,Tennessee,7462,15154,22616,6346105
2005-11,Texas,16330,41599,57929,25145561
2005-11,Utah,1813,5805,7618,2763885
2005-11,Vermont,424,1462,1886,625741
2005-11,Virginia,7557,17045,24602,8001024
2005-11,Washington,5140,8282,13422,6724540
2005-11,West Virginia,2481,10525,13006,1852994
2005-11,Wisconsin,3122,17121,20243,5686986
2005-11,Wyoming,698,1976,2674,563626
2005-10,Alabama,6079,11045,17124,4779736
2005-10,Arizona,5660,6866,12526,6392017
2005-10,Arkansas,2559,9262,11821,2915918
2005-10,California,18712,20693,39405,37253956
2005-10,Colorado,6099,11536,17635,5029196
2005-10,Connecticut,2225,2845,5070,3574097
2005-10,Delaware,483,1173,1656,897934
2005-10,District of Columbia,2,0,2,601723
2005-10,Florida,16712,15828,32540,18801310
2005-10,Georgia,5539,11700,17239,9687653
2005-10,Idaho,1207,4676,5883,1567582
2005-10,Illinois,4554,9306,13860,12830632
2005-10,Indiana,5309,10552,15861,6483802
2005-10,Iowa,24,5758,5782,3046355
2005-10,Kansas,2309,6674,8983,2853118
2005-10,Kentucky,5367,11765,17132,4339367
2005-10,Louisiana,8803,13178,21981,4533372
2005-10,Maine,1256,5997,7253,1328361
2005-10,Maryland,700,5502,6202,5773552
2005-10,Massachusetts,1646,1709,3355,6547629
2005-10,Michigan,2585,18007,20592,9883640
2005-10,Minnesota,3448,20294,23742,5303925
2005-10,Mississippi,4699,10657,15356,2967297
2005-10,Missouri,3832,16422,20254,5988927
2005-10,Montana,1322,6408,7730,989415
2005-10,Nebraska,2,3691,3693,1826341
2005-10,Nevada,2512,2747,5259,2700551
2005-10,New Hampshire,1123,3240,4363,1316470
2005-10,New Jersey,1177,1980,3157,8791894
2005-10,New Mexico,2341,3417,5758,2059179
2005-10,New York,920,14408,15328,19378102
2005-10,North Carolina,167,14182,14349,9535483
2005-10,North Dakota,396,4445,4841,672591
2005-10,Ohio,9033,15455,24488,11536504
2005-10,Oklahoma,4518,9262,13780,3751351
2005-10,Oregon,3949,8803,12752,3831074
2005-10,Pennsylvania,0,44203,44203,12702379
2005-10,Rhode Island,375,437,812,1052567
2005-10,South Carolina,3268,6099,9367,4625364
2005-10,South Dakota,684,6169,6853,814180
2005-10,Tennessee,7107,11116,18223,6346105
2005-10,Texas,16808,36705,53513,25145561
2005-10,Utah,1697,5013,6710,2763885
2005-10,Vermont,502,1678,2180,625741
2005-10,Virginia,7544,12859,20403,8001024
2005-10,Washington,5405,10096,15501,6724540
2005-10,West Virginia,2504,8020,10524,1852994
2005-10,Wisconsin,3538,18093,21631,5686986
2005-10,Wyoming,637,2032,2669,563626
2005-09,Alabama,6627,9708,16335,4779736
2005-09,Arizona,5796,6668,12464,6392017
2005-09,Arkansas,2874,7707,10581,2915918
2005-09,California,19254,21845,41099,37253956
2005-09,Colorado,6050,10305,16355,5029196
2005-09,Connecticut,1775,2176,3951,3574097
2005-09,Delaware,517,886,1403,897934
2005-09,District of Columbia,1,0,1,601723
2005-09,Florida,15752,14118,29870,18801310
2005-09,Georgia,5141,8348,13489,9687653
2005-09,Idaho,1400,4581,5981,1567582
2005-09,Illinois,4310,7610,11920,12830632
2005-09,Indiana,4477,7594,12071,6483802
2005-09,Iowa,29,3747,3776,3046355
2005-09,Kansas,2007,5358,7365,2853118
2005-09,Kentucky,5236,9016,14252,4339367
2005-09,Louisiana,14502,9118,23620,4533372
2005-09,Maine,1230,4102,5332,1328361
2005-09,Maryland,806,4467,5273,5773552
2005-09,Massachusetts,1636,1305,2941,6547629
2005-09,Michigan,2471,16156,18627,9883640
2005-09,Minnesota,3158,16506,19664,5303925
2005-09,Mississippi,5195,6367,11562,2967297
2005-09,Missouri,3650,10974,14624,5988927
2005-09,Montana,1433,4812,6245,989415
2005-09,Nebraska,0,2721,2721,1826341
2005-09,Nevada,2005,2366,4371,2700551
2005-09,New Hampshire,1347,2500,3847,1316470
2005-09,New Jersey,1149,1644,2793,8791894
2005-09,New Mexico,2193,3256,5449,2059179
2005-09,New York,938,11950,12888,19378102
2005-09,North Carolina,137,11693,11830,9535483
2005-09,North Dakota,413,3194,3607,672591
2005-09,Ohio,8467,12915,21382,11536504
2005-09,Oklahoma,3873,7073,10946,3751351
2005-09,Oregon,4494,10907,15401,3831074
2005-09,Pennsylvania,0,41184,41184,12702379
2005-09,Rhode Island,353,421,774,1052567
2005-09,South Carolina,3406,5590,8996,4625364
2005-09,South Dakota,697,4011,4708,814180
2005-09,Tennessee,7117,9340,16457,6346105
2005-09,Texas,16551,35805,52356,25145561
2005-09,Utah,1932,5424,7356,2763885
2005-09,Vermont,483,1381,1864,625741
2005-09,Virginia,7017,10689,17706,8001024
2005-09,Washington,4904,9061,13965,6724540
2005-09,West Virginia,2497,5778,8275,1852994
2005-09,Wisconsin,3373,14795,18168,5686986
2005-09,Wyoming,821,2161,2982,563626
2005-08,Alabama,5407,7212,12619,4779736
2005-08,Arizona,5397,6081,11478,6392017
2005-08,Arkansas,2336,5695,8031,2915918
2005-08,California,18243,20689,38932,37253956
2005-08,Colorado,6011,9114,15125,5029196
2005-08,Connecticut,1770,1618,3388,3574097
2005-08,Delaware,478,745,1223,897934
2005-08,District of Columbia,0,1,1,601723
2005-08,Florida,14600,12282,26882,18801310
2005-08,Georgia,4521,6770,11291,9687653
2005-08,Idaho,1278,3207,4485,1567582
2005-08,Illinois,3853,7722,11575,12830632
2005-08,Indiana,4719,6980,11699,6483802
2005-08,Iowa,21,2554,2575,3046355
2005-08,Kansas,1831,4609,6440,2853118
2005-08,Kentucky,5184,8297,13481,4339367
2005-08,Louisiana,4295,7314,11609,4533372
2005-08,Maine,1094,2487,3581,1328361
2005-08,Maryland,852,3596,4448,5773552
2005-08,Massachusetts,1568,1092,2660,6547629
2005-08,Michigan,2552,11137,13689,9883640
2005-08,Minnesota,3031,10852,13883,5303925
2005-08,Mississippi,2675,5136,7811,2967297
2005-08,Missouri,3779,10838,14617,5988927
2005-08,Montana,1414,3708,5122,989415
2005-08,Nebraska,0,2073,2073,1826341
2005-08,Nevada,2294,2235,4529,2700551
2005-08,New Hampshire,1132,1887,3019,1316470
2005-08,New Jersey,1166,1540,2706,8791894
2005-08,New Mexico,2230,3050,5280,2059179
2005-08,New York,1167,7461,8628,19378102
2005-08,North Carolina,144,9880,10024,9535483
2005-08,North Dakota,377,2197,2574,672591
2005-08,Ohio,8229,12215,20444,11536504
2005-08,Oklahoma,3918,6976,10894,3751351
2005-08,Oregon,3998,6978,10976,3831074
2005-08,Pennsylvania,0,35320,35320,12702379
2005-08,Rhode Island,310,291,601,1052567
2005-08,South Carolina,3036,4826,7862,4625364
2005-08,South Dakota,613,2863,3476,814180
2005-08,Tennessee,6996,9312,16308,6346105
2005-08,Texas,13843,32244,46087,25145561
2005-08,Utah,1372,3278,4650,2763885
2005-08,Vermont,438,816,1254,625741
2005-08,Virginia,6520,8575,15095,8001024
2005-08,Washington,4776,6897,11673,6724540
2005-08,West Virginia,2355,4597,6952,1852994
2005-08,Wisconsin,2835,9789,12624,5686986
2005-08,Wyoming,720,1609,2329,563626
2005-07,Alabama,5130,5046,10176,4779736
2005-07,Arizona,5099,4599,9698,6392017
2005-07,Arkansas,2205,3875,6080,2915918
2005-07,California,17503,16539,34042,37253956
2005-07,Colorado,5431,6882,12313,5029196
2005-07,Connecticut,1719,1470,3189,3574097
2005-07,Delaware,413,556,969,897934
2005-07,District of Columbia,3,0,3,601723
2005-07,Florida,13059,9570,22629,18801310
2005-07,Georgia,4353,5026,9379,9687653
2005-07,Idaho,1104,2250,3354,1567582
2005-07,Illinois,3695,4998,8693,12830632
2005-07,Indiana,4211,5108,9319,6483802
2005-07,Iowa,18,1715,1733,3046355
2005-07,Kansas,1602,2843,4445,2853118
2005-07,Kentucky,5029,6058,11087,4339367
2005-07,Louisiana,3912,4390,8302,4533372
2005-07,Maine,983,1744,2727,1328361
2005-07,Maryland,795,2584,3379,5773552
2005-07,Massachusetts,1375,872,2247,6547629
2005-07,Michigan,2636,7655,10291,9883640
2005-07,Minnesota,2619,6248,8867,5303925
2005-07,Mississippi,2706,3328,6034,2967297
2005-07,Missouri,3214,7254,10468,5988927
2005-07,Montana,1247,2799,4046,989415
2005-07,Nebraska,0,1382,1382,1826341
2005-07,Nevada,1822,1671,3493,2700551
2005-07,New Hampshire,964,1508,2472,1316470
2005-07,New Jersey,1252,1248,2500,8791894
2005-07,New Mexico,1892,2468,4360,2059179
2005-07,New York,1255,5580,6835,19378102
2005-07,North Carolina,122,6727,6849,9535483
2005-07,North Dakota,359,1480,1839,672591
2005-07,Ohio,7803,9532,17335,11536504
2005-07,Oklahoma,3679,4449,8128,3751351
2005-07,Oregon,3638,5531,9169,3831074
2005-07,Pennsylvania,0,31319,31319,12702379
2005-07,Rhode Island,293,267,560,1052567
2005-07,South Carolina,2903,3202,6105,4625364
2005-07,South Dakota,636,1945,2581,814180
2005-07,Tennessee,6532,6397,12929,6346105
2005-07,Texas,13275,21002,34277,25145561
2005-07,Utah,1270,2473,3743,2763885
2005-07,Vermont,419,622,1041,625741
2005-07,Virginia,7183,7379,14562,8001024
2005-07,Washington,4359,5830,10189,6724540
2005-07,West Virginia,2142,3386,5528,1852994
2005-07,Wisconsin,2615,6437,9052,5686986
2005-07,Wyoming,660,1170,1830,563626
2005-06,Alabama,5329,4927,10256,4779736
2005-06,Arizona,4579,4182,8761,6392017
2005-06,Arkansas,2400,3655,6055,2915918
2005-06,California,17730,16877,34607,37253956
2005-06,Colorado,5505,7003,12508,5029196
2005-06,Connecticut,1745,1420,3165,3574097
2005-06,Delaware,467,500,967,897934
2005-06,District of Columbia,3,0,3,601723
2005-06,Florida,14013,9917,23930,18801310
2005-06,Georgia,5125,5315,10440,9687653
2005-06,Idaho,1134,2324,3458,1567582
2005-06,Illinois,3751,4849,8600,12830632
2005-06,Indiana,4448,5214,9662,6483802
2005-06,Iowa,16,1694,1710,3046355
2005-06,Kansas,1642,2657,4299,2853118
2005-06,Kentucky,4837,5708,10545,4339367
2005-06,Louisiana,4032,4039,8071,4533372
2005-06,Maine,901,1613,2514,1328361
2005-06,Maryland,762,2501,3263,5773552
2005-06,Massachusetts,1551,888,2439,6547629
2005-06,Michigan,2434,7274,9708,9883640
2005-06,Minnesota,2617,5792,8409,5303925
2005-06,Mississippi,2432,2905,5337,2967297
2005-06,Missouri,3533,7048,10581,5988927
2005-06,Montana,1264,3232,4496,989415
2005-06,Nebraska,0,1255,1255,1826341
2005-06,Nevada,1788,1742,3530,2700551
2005-06,New Hampshire,986,1372,2358,1316470
2005-06,New Jersey,1239,1196,2435,8791894
2005-06,New Mexico,1997,2317,4314,2059179
2005-06,New York,923,5122,6045,19378102
2005-06,North Carolina,136,6717,6853,9535483
2005-06,North Dakota,383,1470,1853,672591
2005-06,Ohio,7844,9678,17522,11536504
2005-06,Oklahoma,3314,4360,7674,3751351
2005-06,Oregon,4110,6735,10845,3831074
2005-06,Pennsylvania,0,30772,30772,12702379
2005-06,Rhode Island,289,209,498,1052567
2005-06,South Carolina,2974,2758,5732,4625364
2005-06,South Dakota,569,1860,2429,814180
2005-06,Tennessee,6190,5626,11816,6346105
2005-06,Texas,12565,17409,29974,25145561
2005-06,Utah,1432,2750,4182,2763885
2005-06,Vermont,403,578,981,625741
2005-06,Virginia,5614,6572,12186,8001024
2005-06,Washington,4720,6039,10759,6724540
2005-06,West Virginia,2048,3085,5133,1852994
2005-06,Wisconsin,2605,6075,8680,5686986
2005-06,Wyoming,644,1269,1913,563626
2005-05,Alabama,5138,4607,9745,4779736
2005-05,Arizona,4916,4222,9138,6392017
2005-05,Arkansas,2196,3277,5473,2915918
2005-05,California,17509,17486,34995,37253956
2005-05,Colorado,5498,6989,12487,5029196
2005-05,Connecticut,1914,1470,3384,3574097
2005-05,Delaware,460,589,1049,897934
2005-05,District of Columbia,2,0,2,601723
2005-05,Florida,13750,9408,23158,18801310
2005-05,Georgia,4932,5193,10125,9687653
2005-05,Idaho,1093,2581,3674,1567582
2005-05,Illinois,4011,4967,8978,12830632
2005-05,Indiana,4559,4991,9550,6483802
2005-05,Iowa,20,1761,1781,3046355
2005-05,Kansas,1505,2770,4275,2853118
2005-05,Kentucky,4825,5293,10118,4339367
2005-05,Louisiana,3621,3604,7225,4533372
2005-05,Maine,1015,1899,2914,1328361
2005-05,Maryland,833,2396,3229,5773552
2005-05,Massachusetts,1617,998,2615,6547629
2005-05,Michigan,2717,8481,11198,9883640
2005-05,Minnesota,2619,6248,8867,5303925
2005-05,Mississippi,2609,2793,5402,2967297
2005-05,Missouri,3335,6799,10134,5988927
2005-05,Montana,1218,3196,4414,989415
2005-05,Nebraska,0,1283,1283,1826341
2005-05,Nevada,1905,1757,3662,2700551
2005-05,New Hampshire,1197,1709,2906,1316470
2005-05,New Jersey,1370,1273,2643,8791894
2005-05,New Mexico,2022,2341,4363,2059179
2005-05,New York,1009,6174,7183,19378102
2005-05,North Carolina,132,6335,6467,9535483
2005-05,North Dakota,406,1453,1859,672591
2005-05,Ohio,8720,10095,18815,11536504
2005-05,Oklahoma,3655,4577,8232,3751351
2005-05,Oregon,3868,6861,10729,3831074
2005-05,Pennsylvania,0,32008,32008,12702379
2005-05,Rhode Island,353,266,619,1052567
2005-05,South Carolina,2773,2619,5392,4625364
2005-05,South Dakota,632,1971,2603,814180
2005-05,Tennessee,6210,5468,11678,6346105
2005-05,Texas,13062,17413,30475,25145561
2005-05,Utah,1367,2668,4035,2763885
2005-05,Vermont,479,674,1153,625741
2005-05,Virginia,6395,6926,13321,8001024
2005-05,Washington,4498,5934,10432,6724540
2005-05,West Virginia,2191,3238,5429,1852994
2005-05,Wisconsin,2838,7361,10199,5686986
2005-05,Wyoming,685,1250,1935,563626
2005-04,Alabama,5689,5569,11258,4779736
2005-04,Arizona,5870,4792,10662,6392017
2005-04,Arkansas,2550,4394,6944,2915918
2005-04,California,18183,18109,36292,37253956
2005-04,Colorado,6594,8497,15091,5029196
2005-04,Connecticut,2392,1907,4299,3574097
2005-04,Delaware,545,684,1229,897934
2005-04,District of Columbia,1,0,1,601723
2005-04,Florida,15256,11033,26289,18801310
2005-04,Georgia,5545,6111,11656,9687653
2005-04,Idaho,1243,3074,4317,1567582
2005-04,Illinois,4604,6319,10923,12830632
2005-04,Indiana,5464,7051,12515,6483802
2005-04,Iowa,20,2701,2721,3046355
2005-04,Kansas,1870,3717,5587,2853118
2005-04,Kentucky,5419,8169,13588,4339367
2005-04,Louisiana,4494,3959,8453,4533372
2005-04,Maine,1229,2353,3582,1328361
2005-04,Maryland,961,3282,4243,5773552
2005-04,Massachusetts,1693,1326,3019,6547629
2005-04,Michigan,3237,11519,14756,9883640
2005-04,Minnesota,3236,9840,13076,5303925
2005-04,Mississippi,3159,3270,6429,2967297
2005-04,Missouri,3880,10599,14479,5988927
2005-04,Montana,1523,3895,5418,989415
2005-04,Nebraska,0,1620,1620,1826341
2005-04,Nevada,2046,1973,4019,2700551
2005-04,New Hampshire,1420,2272,3692,1316470
2005-04,New Jersey,1342,1453,2795,8791894
2005-04,New Mexico,2145,2833,4978,2059179
2005-04,New York,1100,8477,9577,19378102
2005-04,North Carolina,136,7884,8020,9535483
2005-04,North Dakota,490,1726,2216,672591
2005-04,Ohio,10592,12945,23537,11536504
2005-04,Oklahoma,4396,5933,10329,3751351
2005-04,Oregon,4694,8970,13664,3831074
2005-04,Pennsylvania,0,40016,40016,12702379
2005-04,Rhode Island,374,374,748,1052567
2005-04,South Carolina,3581,3230,6811,4625364
2005-04,South Dakota,841,2513,3354,814180
2005-04,Tennessee,6702,7058,13760,6346105
2005-04,Texas,14481,18359,32840,25145561
2005-04,Utah,1668,3066,4734,2763885
2005-04,Vermont,540,1152,1692,625741
2005-04,Virginia,7905,9020,16925,8001024
2005-04,Washington,5416,6769,12185,6724540
2005-04,West Virginia,2673,4597,7270,1852994
2005-04,Wisconsin,3470,12561,16031,5686986
2005-04,Wyoming,848,1498,2346,563626
2005-03,Alabama,7147,7792,14939,4779736
2005-03,Arizona,5969,5092,11061,6392017
2005-03,Arkansas,3121,5513,8634,2915918
2005-03,California,19732,19488,39220,37253956
2005-03,Colorado,7100,9644,16744,5029196
2005-03,Connecticut,2577,2265,4842,3574097
2005-03,Delaware,614,788,1402,897934
2005-03,District of Columbia,1,0,1,601723
2005-03,Florida,14452,12328,26780,18801310
2005-03,Georgia,7066,8583,15649,9687653
2005-03,Idaho,1340,3198,4538,1567582
2005-03,Illinois,6485,9066,15551,12830632
2005-03,Indiana,7100,8475,15575,6483802
2005-03,Iowa,31,3917,3948,3046355
2005-03,Kansas,2606,4313,6919,2853118
2005-03,Kentucky,7210,9584,16794,4339367
2005-03,Louisiana,5005,5325,10330,4533372
2005-03,Maine,1324,2257,3581,1328361
2005-03,Maryland,1006,3954,4960,5773552
2005-03,Massachusetts,2542,1550,4092,6547629
2005-03,Michigan,3473,13770,17243,9883640
2005-03,Minnesota,4133,10585,14718,5303925
2005-03,Mississippi,3361,4897,8258,2967297
2005-03,Missouri,5006,11328,16334,5988927
2005-03,Montana,1508,3667,5175,989415
2005-03,Nebraska,2,1908,1910,1826341
2005-03,Nevada,2549,2264,4813,2700551
2005-03,New Hampshire,1287,1990,3277,1316470
2005-03,New Jersey,1637,1751,3388,8791894
2005-03,New Mexico,2599,3397,5996,2059179
2005-03,New York,1256,8020,9276,19378102
2005-03,North Carolina,181,9918,10099,9535483
2005-03,North Dakota,587,1808,2395,672591
2005-03,Ohio,12805,14385,27190,11536504
2005-03,Oklahoma,4638,6063,10701,3751351
2005-03,Oregon,5029,9014,14043,3831074
2005-03,Pennsylvania,0,48228,48228,12702379
2005-03,Rhode Island,474,432,906,1052567
2005-03,South Carolina,4232,4609,8841,4625364
2005-03,South Dakota,1000,2575,3575,814180
2005-03,Tennessee,8607,9387,17994,6346105
2005-03,Texas,15867,20493,36360,25145561
2005-03,Utah,1795,3544,5339,2763885
2005-03,Vermont,647,1066,1713,625741
2005-03,Virginia,8985,10129,19114,8001024
2005-03,Washington,5971,7402,13373,6724540
2005-03,West Virginia,3627,5628,9255,1852994
2005-03,Wisconsin,4714,14430,19144,5686986
2005-03,Wyoming,786,1614,2400,563626
2005-02,Alabama,7557,8421,15978,4779736
2005-02,Arizona,6528,5588,12116,6392017
2005-02,Arkansas,3634,6274,9908,2915918
2005-02,California,17281,17993,35274,37253956
2005-02,Colorado,6619,8675,15294,5029196
2005-02,Connecticut,2560,1892,4452,3574097
2005-02,Delaware,530,731,1261,897934
2005-02,District of Columbia,0,0,0,601723
2005-02,Florida,14612,12797,27409,18801310
2005-02,Georgia,8096,9588,17684,9687653
2005-02,Idaho,1424,3054,4478,1567582
2005-02,Illinois,5852,8070,13922,12830632
2005-02,Indiana,6762,7999,14761,6483802
2005-02,Iowa,20,3303,3323,3046355
2005-02,Kansas,2460,4317,6777,2853118
2005-02,Kentucky,7382,9929,17311,4339367
2005-02,Louisiana,5331,5715,11046,4533372
2005-02,Maine,1141,1957,3098,1328361
2005-02,Maryland,823,3744,4567,5773552
2005-02,Massachusetts,1896,1213,3109,6547629
2005-02,Michigan,2880,12241,15121,9883640
2005-02,Minnesota,3261,8001,11262,5303925
2005-02,Mississippi,4545,5634,10179,2967297
2005-02,Missouri,4786,11371,16157,5988927
2005-02,Montana,1416,3135,4551,989415
2005-02,Nebraska,0,1872,1872,1826341
2005-02,Nevada,2179,2181,4360,2700551
2005-02,New Hampshire,1228,1720,2948,1316470
2005-02,New Jersey,1347,1469,2816,8791894
2005-02,New Mexico,2576,3271,5847,2059179
2005-02,New York,1164,7693,8857,19378102
2005-02,North Carolina,211,10852,11063,9535483
2005-02,North Dakota,472,1602,2074,672591
2005-02,Ohio,12848,13380,26228,11536504
2005-02,Oklahoma,5570,7198,12768,3751351
2005-02,Oregon,4778,8056,12834,3831074
2005-02,Pennsylvania,1,38863,38864,12702379
2005-02,Rhode Island,359,333,692,1052567
2005-02,South Carolina,4776,4744,9520,4625364
2005-02,South Dakota,862,2684,3546,814180
2005-02,Tennessee,9494,10146,19640,6346105
2005-02,Texas,17163,22081,39244,25145561
2005-02,Utah,1782,3632,5414,2763885
2005-02,Vermont,647,981,1628,625741
2005-02,Virginia,8540,9559,18099,8001024
2005-02,Washington,5721,7401,13122,6724540
2005-02,West Virginia,3383,5207,8590,1852994
2005-02,Wisconsin,3851,11709,15560,5686986
2005-02,Wyoming,863,1545,2408,563626
2005-01,Alabama,6891,8969,15860,4779736
2005-01,Arizona,5319,4947,10266,6392017
2005-01,Arkansas,2917,6350,9267,2915918
2005-01,California,15772,17140,32912,37253956
2005-01,Colorado,6220,9714,15934,5029196
2005-01,Connecticut,1952,1866,3818,3574097
2005-01,Delaware,438,763,1201,897934
2005-01,District of Columbia,1,0,1,601723
2005-01,Florida,14017,13163,27180,18801310
2005-01,Georgia,6363,8909,15272,9687653
2005-01,Idaho,1063,2376,3439,1567582
2005-01,Illinois,5025,7355,12380,12830632
2005-01,Indiana,5786,7377,13163,6483802
2005-01,Iowa,32,2898,2930,3046355
2005-01,Kansas,2221,4600,6821,2853118
2005-01,Kentucky,6439,8975,15414,4339367
2005-01,Louisiana,4460,6096,10556,4533372
2005-01,Maine,1075,1776,2851,1328361
2005-01,Maryland,749,3239,3988,5773552
2005-01,Massachusetts,1555,1258,2813,6547629
2005-01,Michigan,2662,10331,12993,9883640
2005-01,Minnesota,2689,6107,8796,5303925
2005-01,Mississippi,3541,5555,9096,2967297
2005-01,Missouri,3866,10512,14378,5988927
2005-01,Montana,1031,2479,3510,989415
2005-01,Nebraska,2,2021,2023,1826341
2005-01,Nevada,1915,1920,3835,2700551
2005-01,New Hampshire,1287,1728,3015,1316470
2005-01,New Jersey,1263,1589,2852,8791894
2005-01,New Mexico,1902,2782,4684,2059179
2005-01,New York,1360,6624,7984,19378102
2005-01,North Carolina,162,10708,10870,9535483
2005-01,North Dakota,375,1381,1756,672591
2005-01,Ohio,9768,11744,21512,11536504
2005-01,Oklahoma,4255,6554,10809,3751351
2005-01,Oregon,4151,6726,10877,3831074
2005-01,Pennsylvania,0,33930,33930,12702379
2005-01,Rhode Island,362,381,743,1052567
2005-01,South Carolina,3613,4360,7973,4625364
2005-01,South Dakota,720,2168,2888,814180
2005-01,Tennessee,8121,9578,17699,6346105
2005-01,Texas,14755,23127,37882,25145561
2005-01,Utah,1421,3146,4567,2763885
2005-01,Vermont,447,640,1087,625741
2005-01,Virginia,7039,9136,16175,8001024
2005-01,Washington,4647,6147,10794,6724540
2005-01,West Virginia,2640,4332,6972,1852994
2005-01,Wisconsin,2887,7931,10818,5686986
2005-01,Wyoming,702,1281,1983,563626
2004-12,Alabama,8115,25434,33549,4779736
2004-12,Arizona,6489,9307,15796,6392017
2004-12,Arkansas,3415,15276,18691,2915918
2004-12,California,17147,28376,45523,37253956
2004-12,Colorado,7418,16113,23531,5029196
2004-12,Connecticut,2331,2966,5297,3574097
2004-12,Delaware,494,1954,2448,897934
2004-12,District of Columbia,0,0,0,601723
2004-12,Florida,15844,27777,43621,18801310
2004-12,Georgia,8075,24267,32342,9687653
2004-12,Idaho,1501,5368,6869,1567582
2004-12,Illinois,5559,13973,19532,12830632
2004-12,Indiana,5983,15529,21512,6483802
2004-12,Iowa,28,7734,7762,3046355
2004-12,Kansas,2304,9974,12278,2853118
2004-12,Kentucky,7905,21141,29046,4339367
2004-12,Louisiana,5219,19053,24272,4533372
2004-12,Maine,1175,3921,5096,1328361
2004-12,Maryland,853,7127,7980,5773552
2004-12,Massachusetts,1857,1707,3564,6547629
2004-12,Michigan,2890,21851,24741,9883640
2004-12,Minnesota,3423,13035,16458,5303925
2004-12,Mississippi,3974,17025,20999,2967297
2004-12,Missouri,4620,21685,26305,5988927
2004-12,Montana,1564,5211,6775,989415
2004-12,Nebraska,6,5141,5147,1826341
2004-12,Nevada,2152,3756,5908,2700551
2004-12,New Hampshire,1257,2923,4180,1316470
2004-12,New Jersey,1225,2695,3920,8791894
2004-12,New Mexico,2565,5531,8096,2059179
2004-12,New York,983,13959,14942,19378102
2004-12,North Carolina,189,27209,27398,9535483
2004-12,North Dakota,499,2817,3316,672591
2004-12,Ohio,11660,24059,35719,11536504
2004-12,Oklahoma,4957,14808,19765,3751351
2004-12,Oregon,5118,13811,18929,3831074
2004-12,Pennsylvania,0,50690,50690,12702379
2004-12,Rhode Island,373,527,900,1052567
2004-12,South Carolina,4350,12322,16672,4625364
2004-12,South Dakota,879,4645,5524,814180
2004-12,Tennessee,9664,23643,33307,6346105
2004-12,Texas,17267,55935,73202,25145561
2004-12,Utah,2328,8467,10795,2763885
2004-12,Vermont,522,1380,1902,625741
2004-12,Virginia,8482,20469,28951,8001024
2004-12,Washington,5622,11483,17105,6724540
2004-12,West Virginia,3549,10327,13876,1852994
2004-12,Wisconsin,3770,14515,18285,5686986
2004-12,Wyoming,1077,2895,3972,563626
2004-11,Alabama,5795,16779,22574,4779736
2004-11,Arizona,4378,5465,9843,6392017
2004-11,Arkansas,2280,12891,15171,2915918
2004-11,California,14509,20957,35466,37253956
2004-11,Colorado,5826,10526,16352,5029196
2004-11,Connecticut,1676,2852,4528,3574097
2004-11,Delaware,400,1618,2018,897934
2004-11,District of Columbia,0,0,0,601723
2004-11,Florida,12819,19106,31925,18801310
2004-11,Georgia,5465,14458,19923,9687653
2004-11,Idaho,951,3345,4296,1567582
2004-11,Illinois,4377,12153,16530,12830632
2004-11,Indiana,5101,14599,19700,6483802
2004-11,Iowa,23,6952,6975,3046355
2004-11,Kansas,1999,9171,11170,2853118
2004-11,Kentucky,5683,16300,21983,4339367
2004-11,Louisiana,3645,13292,16937,4533372
2004-11,Maine,1045,4013,5058,1328361
2004-11,Maryland,952,7262,8214,5773552
2004-11,Massachusetts,1503,1815,3318,6547629
2004-11,Michigan,2362,23198,25560,9883640
2004-11,Minnesota,2446,12425,14871,5303925
2004-11,Mississippi,3376,13124,16500,2967297
2004-11,Missouri,3348,17369,20717,5988927
2004-11,Montana,959,3636,4595,989415
2004-11,Nebraska,5,4310,4315,1826341
2004-11,Nevada,1760,2464,4224,2700551
2004-11,New Hampshire,1046,2735,3781,1316470
2004-11,New Jersey,1214,2848,4062,8791894
2004-11,New Mexico,1804,3647,5451,2059179
2004-11,New York,887,15358,16245,19378102
2004-11,North Carolina,157,18447,18604,9535483
2004-11,North Dakota,352,2547,2899,672591
2004-11,Ohio,9488,24628,34116,11536504
2004-11,Oklahoma,3510,10915,14425,3751351
2004-11,Oregon,3775,8782,12557,3831074
2004-11,Pennsylvania,0,54270,54270,12702379
2004-11,Rhode Island,334,569,903,1052567
2004-11,South Carolina,2980,7599,10579,4625364
2004-11,South Dakota,595,4193,4788,814180
2004-11,Tennessee,7231,16117,23348,6346105
2004-11,Texas,12166,35950,48116,25145561
2004-11,Utah,1569,4621,6190,2763885
2004-11,Vermont,433,1575,2008,625741
2004-11,Virginia,6451,16670,23121,8001024
2004-11,Washington,4532,7976,12508,6724540
2004-11,West Virginia,2312,10831,13143,1852994
2004-11,Wisconsin,3150,17315,20465,5686986
2004-11,Wyoming,580,1737,2317,563626
2004-10,Alabama,5426,11623,17049,4779736
2004-10,Arizona,4357,6047,10404,6392017
2004-10,Arkansas,2221,10346,12567,2915918
2004-10,California,15401,19403,34804,37253956
2004-10,Colorado,6792,13831,20623,5029196
2004-10,Connecticut,2149,2927,5076,3574097
2004-10,Delaware,406,1250,1656,897934
2004-10,District of Columbia,0,0,0,601723
2004-10,Florida,12988,16394,29382,18801310
2004-10,Georgia,5709,14507,20216,9687653
2004-10,Idaho,1044,4331,5375,1567582
2004-10,Illinois,4523,10181,14704,12830632
2004-10,Indiana,5521,11808,17329,6483802
2004-10,Iowa,24,6047,6071,3046355
2004-10,Kansas,2152,7668,9820,2853118
2004-10,Kentucky,5349,14162,19511,4339367
2004-10,Louisiana,3705,12407,16112,4533372
2004-10,Maine,1205,6656,7861,1328361
2004-10,Maryland,278,5483,5761,5773552
2004-10,Massachusetts,1501,1628,3129,6547629
2004-10,Michigan,2790,21132,23922,9883640
2004-10,Minnesota,3158,20394,23552,5303925
2004-10,Mississippi,2786,8592,11378,2967297
2004-10,Missouri,3603,17120,20723,5988927
2004-10,Montana,1233,6354,7587,989415
2004-10,Nebraska,21,4123,4144,1826341
2004-10,Nevada,2002,2510,4512,2700551
2004-10,New Hampshire,1188,3423,4611,1316470
2004-10,New Jersey,1173,2312,3485,8791894
2004-10,New Mexico,2143,4014,6157,2059179
2004-10,New York,970,15386,16356,19378102
2004-10,North Carolina,145,15005,15150,9535483
2004-10,North Dakota,410,4305,4715,672591
2004-10,Ohio,9123,17340,26463,11536504
2004-10,Oklahoma,3651,9048,12699,3751351
2004-10,Oregon,3665,9105,12770,3831074
2004-10,Pennsylvania,0,49444,49444,12702379
2004-10,Rhode Island,340,542,882,1052567
2004-10,South Carolina,2933,6295,9228,4625364
2004-10,South Dakota,632,6323,6955,814180
2004-10,Tennessee,7236,12694,19930,6346105
2004-10,Texas,12067,33043,45110,25145561
2004-10,Utah,1350,4777,6127,2763885
2004-10,Vermont,534,2028,2562,625741
2004-10,Virginia,7167,14785,21952,8001024
2004-10,Washington,4668,9554,14222,6724540
2004-10,West Virginia,2404,9150,11554,1852994
2004-10,Wisconsin,3226,19533,22759,5686986
2004-10,Wyoming,581,1857,2438,563626
2004-09,Alabama,4597,9438,14035,4779736
2004-09,Arizona,4584,5711,10295,6392017
2004-09,Arkansas,2311,7862,10173,2915918
2004-09,California,14367,18469,32836,37253956
2004-09,Colorado,5691,10900,16591,5029196
2004-09,Connecticut,1657,2121,3778,3574097
2004-09,Delaware,367,1028,1395,897934
2004-09,District of Columbia,4,0,4,601723
2004-09,Florida,9470,10334,19804,18801310
2004-09,Georgia,4971,10383,15354,9687653
2004-09,Idaho,1134,4481,5615,1567582
2004-09,Illinois,3784,8145,11929,12830632
2004-09,Indiana,4300,8169,12469,6483802
2004-09,Iowa,30,3944,3974,3046355
2004-09,Kansas,1652,5213,6865,2853118
2004-09,Kentucky,4855,10264,15119,4339367
2004-09,Louisiana,3653,9220,12873,4533372
2004-09,Maine,1167,4586,5753,1328361
2004-09,Maryland,35,4562,4597,5773552
2004-09,Massachusetts,1550,1547,3097,6547629
2004-09,Michigan,2367,17151,19518,9883640
2004-09,Minnesota,2599,18072,20671,5303925
2004-09,Mississippi,2500,5920,8420,2967297
2004-09,Missouri,3326,11533,14859,5988927
2004-09,Montana,1316,4835,6151,989415
2004-09,Nebraska,12,2838,2850,1826341
2004-09,Nevada,1758,2441,4199,2700551
2004-09,New Hampshire,1272,2684,3956,1316470
2004-09,New Jersey,1080,1870,2950,8791894
2004-09,New Mexico,1924,3553,5477,2059179
2004-09,New York,853,11869,12722,19378102
2004-09,North Carolina,153,12133,12286,9535483
2004-09,North Dakota,396,3034,3430,672591
2004-09,Ohio,8416,13581,21997,11536504
2004-09,Oklahoma,3304,7042,10346,3751351
2004-09,Oregon,4230,10981,15211,3831074
2004-09,Pennsylvania,0,41552,41552,12702379
2004-09,Rhode Island,351,422,773,1052567
2004-09,South Carolina,2801,5739,8540,4625364
2004-09,South Dakota,649,4285,4934,814180
2004-09,Tennessee,6395,10205,16600,6346105
2004-09,Texas,11606,34694,46300,25145561
2004-09,Utah,1422,4411,5833,2763885
2004-09,Vermont,481,1473,1954,625741
2004-09,Virginia,6223,12129,18352,8001024
2004-09,Washington,4230,8780,13010,6724540
2004-09,West Virginia,2121,6131,8252,1852994
2004-09,Wisconsin,2976,15717,18693,5686986
2004-09,Wyoming,681,2118,2799,563626
2004-08,Alabama,4928,8023,12951,4779736
2004-08,Arizona,4093,5113,9206,6392017
2004-08,Arkansas,2088,5745,7833,2915918
2004-08,California,13996,19251,33247,37253956
2004-08,Colorado,5315,8819,14134,5029196
2004-08,Connecticut,1728,1678,3406,3574097
2004-08,Delaware,388,801,1189,897934
2004-08,District of Columbia,0,0,0,601723
2004-08,Florida,10959,10461,21420,18801310
2004-08,Georgia,5109,8769,13878,9687653
2004-08,Idaho,1016,2867,3883,1567582
2004-08,Illinois,3909,7980,11889,12830632
2004-08,Indiana,4672,7981,12653,6483802
2004-08,Iowa,18,2875,2893,3046355
2004-08,Kansas,1682,4460,6142,2853118
2004-08,Kentucky,4817,9163,13980,4339367
2004-08,Louisiana,3635,7167,10802,4533372
2004-08,Maine,1120,2610,3730,1328361
2004-08,Maryland,22,3824,3846,5773552
2004-08,Massachusetts,1580,1141,2721,6547629
2004-08,Michigan,2418,12454,14872,9883640
2004-08,Minnesota,2787,11671,14458,5303925
2004-08,Mississippi,2836,5851,8687,2967297
2004-08,Missouri,3427,10606,14033,5988927
2004-08,Montana,1301,3800,5101,989415
2004-08,Nebraska,14,2222,2236,1826341
2004-08,Nevada,1856,2049,3905,2700551
2004-08,New Hampshire,1068,1912,2980,1316470
2004-08,New Jersey,1104,1642,2746,8791894
2004-08,New Mexico,2012,3026,5038,2059179
2004-08,New York,752,7714,8466,19378102
2004-08,North Carolina,147,10608,10755,9535483
2004-08,North Dakota,299,2147,2446,672591
2004-08,Ohio,8273,13025,21298,11536504
2004-08,Oklahoma,3441,6591,10032,3751351
2004-08,Oregon,3419,6796,10215,3831074
2004-08,Pennsylvania,0,36647,36647,12702379
2004-08,Rhode Island,286,332,618,1052567
2004-08,South Carolina,2709,4661,7370,4625364
2004-08,South Dakota,614,3050,3664,814180
2004-08,Tennessee,6140,9822,15962,6346105
2004-08,Texas,11091,28538,39629,25145561
2004-08,Utah,1411,2998,4409,2763885
2004-08,Vermont,386,887,1273,625741
2004-08,Virginia,6191,9693,15884,8001024
2004-08,Washington,4047,6543,10590,6724540
2004-08,West Virginia,2281,4992,7273,1852994
2004-08,Wisconsin,2774,10566,13340,5686986
2004-08,Wyoming,597,1436,2033,563626
2004-07,Alabama,4984,5741,10725,4779736
2004-07,Arizona,4162,4007,8169,6392017
2004-07,Arkansas,2130,3719,5849,2915918
2004-07,California,13996,16547,30543,37253956
2004-07,Colorado,5242,6717,11959,5029196
2004-07,Connecticut,1721,1563,3284,3574097
2004-07,Delaware,372,571,943,897934
2004-07,District of Columbia,1,0,1,601723
2004-07,Florida,10740,9001,19741,18801310
2004-07,Georgia,4978,6803,11781,9687653
2004-07,Idaho,1028,2273,3301,1567582
2004-07,Illinois,3663,5609,9272,12830632
2004-07,Indiana,4254,5491,9745,6483802
2004-07,Iowa,26,1767,1793,3046355
2004-07,Kansas,1603,3105,4708,2853118
2004-07,Kentucky,4827,6252,11079,4339367
2004-07,Louisiana,3849,4444,8293,4533372
2004-07,Maine,1007,1949,2956,1328361
2004-07,Maryland,60,2888,2948,5773552
2004-07,Massachusetts,1448,1030,2478,6547629
2004-07,Michigan,2532,8864,11396,9883640
2004-07,Minnesota,2611,6686,9297,5303925
2004-07,Mississippi,2638,3513,6151,2967297
2004-07,Missouri,3270,7501,10771,5988927
2004-07,Montana,1209,2835,4044,989415
2004-07,Nebraska,10,1473,1483,1826341
2004-07,Nevada,1908,1931,3839,2700551
2004-07,New Hampshire,992,1680,2672,1316470
2004-07,New Jersey,1065,1269,2334,8791894
2004-07,New Mexico,1656,2344,4000,2059179
2004-07,New York,785,5806,6591,19378102
2004-07,North Carolina,138,7236,7374,9535483
2004-07,North Dakota,312,1493,1805,672591
2004-07,Ohio,8171,9880,18051,11536504
2004-07,Oklahoma,3329,4602,7931,3751351
2004-07,Oregon,3260,5783,9043,3831074
2004-07,Pennsylvania,0,33795,33795,12702379
2004-07,Rhode Island,317,274,591,1052567
2004-07,South Carolina,2652,2904,5556,4625364
2004-07,South Dakota,626,2055,2681,814180
2004-07,Tennessee,6422,6872,13294,6346105
2004-07,Texas,10779,17747,28526,25145561
2004-07,Utah,1339,2711,4050,2763885
2004-07,Vermont,456,752,1208,625741
2004-07,Virginia,6874,7779,14653,8001024
2004-07,Washington,4210,5410,9620,6724540
2004-07,West Virginia,2092,3289,5381,1852994
2004-07,Wisconsin,2635,6810,9445,5686986
2004-07,Wyoming,579,1314,1893,563626
2004-06,Alabama,5010,5078,10088,4779736
2004-06,Arizona,3840,3801,7641,6392017
2004-06,Arkansas,2062,3414,5476,2915918
2004-06,California,13983,15949,29932,37253956
2004-06,Colorado,4978,6124,11102,5029196
2004-06,Connecticut,1622,1557,3179,3574097
2004-06,Delaware,343,563,906,897934
2004-06,District of Columbia,0,0,0,601723
2004-06,Florida,11108,8873,19981,18801310
2004-06,Georgia,4772,5639,10411,9687653
2004-06,Idaho,929,2086,3015,1567582
2004-06,Illinois,3530,4949,8479,12830632
2004-06,Indiana,4467,5325,9792,6483802
2004-06,Iowa,19,1781,1800,3046355
2004-06,Kansas,1625,2890,4515,2853118
2004-06,Kentucky,4542,5491,10033,4339367
2004-06,Louisiana,3748,3742,7490,4533372
2004-06,Maine,982,1677,2659,1328361
2004-06,Maryland,58,2684,2742,5773552
2004-06,Massachusetts,1523,1008,2531,6547629
2004-06,Michigan,2542,8122,10664,9883640
2004-06,Minnesota,2756,5998,8754,5303925
2004-06,Mississippi,2580,2999,5579,2967297
2004-06,Missouri,3392,6748,10140,5988927
2004-06,Montana,1255,3115,4370,989415
2004-06,Nebraska,10,1392,1402,1826341
2004-06,Nevada,1798,1710,3508,2700551
2004-06,New Hampshire,1045,1477,2522,1316470
2004-06,New Jersey,1174,1237,2411,8791894
2004-06,New Mexico,1758,2276,4034,2059179
2004-06,New York,686,5400,6086,19378102
2004-06,North Carolina,160,6582,6742,9535483
2004-06,North Dakota,319,1296,1615,672591
2004-06,Ohio,8839,9361,18200,11536504
2004-06,Oklahoma,3188,4382,7570,3751351
2004-06,Oregon,3670,6144,9814,3831074
2004-06,Pennsylvania,0,32034,32034,12702379
2004-06,Rhode Island,356,293,649,1052567
2004-06,South Carolina,2602,2528,5130,4625364
2004-06,South Dakota,626,1894,2520,814180
2004-06,Tennessee,5900,5731,11631,6346105
2004-06,Texas,10691,16034,26725,25145561
2004-06,Utah,1330,2475,3805,2763885
2004-06,Vermont,401,624,1025,625741
2004-06,Virginia,5100,6506,11606,8001024
2004-06,Washington,4225,5409,9634,6724540
2004-06,West Virginia,1928,2984,4912,1852994
2004-06,Wisconsin,2546,6327,8873,5686986
2004-06,Wyoming,659,1263,1922,563626
2004-05,Alabama,4731,4614,9345,4779736
2004-05,Arizona,4359,4044,8403,6392017
2004-05,Arkansas,2103,3267,5370,2915918
2004-05,California,13517,15906,29423,37253956
2004-05,Colorado,5173,6188,11361,5029196
2004-05,Connecticut,1191,1092,2283,3574097
2004-05,Delaware,356,520,876,897934
2004-05,District of Columbia,2,0,2,601723
2004-05,Florida,10806,8582,19388,18801310
2004-05,Georgia,4748,5282,10030,9687653
2004-05,Idaho,1025,2599,3624,1567582
2004-05,Illinois,3960,5238,9198,12830632
2004-05,Indiana,4384,4961,9345,6483802
2004-05,Iowa,18,1706,1724,3046355
2004-05,Kansas,1494,2750,4244,2853118
2004-05,Kentucky,4460,5243,9703,4339367
2004-05,Louisiana,3506,3521,7027,4533372
2004-05,Maine,930,1746,2676,1328361
2004-05,Maryland,64,2223,2287,5773552
2004-05,Massachusetts,1508,1018,2526,6547629
2004-05,Michigan,2797,9153,11950,9883640
2004-05,Minnesota,3267,6544,9811,5303925
2004-05,Mississippi,2816,3030,5846,2967297
2004-05,Missouri,3406,6650,10056,5988927
2004-05,Montana,1352,3197,4549,989415
2004-05,Nebraska,12,1382,1394,1826341
2004-05,Nevada,1840,1956,3796,2700551
2004-05,New Hampshire,989,1530,2519,1316470
2004-05,New Jersey,1235,1207,2442,8791894
2004-05,New Mexico,1852,2245,4097,2059179
2004-05,New York,763,5709,6472,19378102
2004-05,North Carolina,137,6345,6482,9535483
2004-05,North Dakota,355,1478,1833,672591
2004-05,Ohio,9791,9052,18843,11536504
2004-05,Oklahoma,3422,4344,7766,3751351
2004-05,Oregon,3575,6712,10287,3831074
2004-05,Pennsylvania,0,31552,31552,12702379
2004-05,Rhode Island,373,277,650,1052567
2004-05,South Carolina,2688,2486,5174,4625364
2004-05,South Dakota,611,1955,2566,814180
2004-05,Tennessee,5884,5557,11441,6346105
2004-05,Texas,11154,15906,27060,25145561
2004-05,Utah,1371,2643,4014,2763885
2004-05,Vermont,460,723,1183,625741
2004-05,Virginia,6023,6548,12571,8001024
2004-05,Washington,4408,5940,10348,6724540
2004-05,West Virginia,2026,2850,4876,1852994
2004-05,Wisconsin,3093,7440,10533,5686986
2004-05,Wyoming,630,1241,1871,563626
2004-04,Alabama,5436,5490,10926,4779736
2004-04,Arizona,4857,4337,9194,6392017
2004-04,Arkansas,2489,4121,6610,2915918
2004-04,California,14876,15794,30670,37253956
2004-04,Colorado,5902,7183,13085,5029196
2004-04,Connecticut,1778,1859,3637,3574097
2004-04,Delaware,492,628,1120,897934
2004-04,District of Columbia,2,0,2,601723
2004-04,Florida,11542,9375,20917,18801310
2004-04,Georgia,5285,5887,11172,9687653
2004-04,Idaho,1163,2737,3900,1567582
2004-04,Illinois,4295,6500,10795,12830632
2004-04,Indiana,4988,6509,11497,6483802
2004-04,Iowa,26,2586,2612,3046355
2004-04,Kansas,2094,3674,5768,2853118
2004-04,Kentucky,5297,8055,13352,4339367
2004-04,Louisiana,3830,3864,7694,4533372
2004-04,Maine,1105,2107,3212,1328361
2004-04,Maryland,60,3194,3254,5773552
2004-04,Massachusetts,1753,1232,2985,6547629
2004-04,Michigan,3195,11559,14754,9883640
2004-04,Minnesota,3769,9351,13120,5303925
2004-04,Mississippi,2908,3273,6181,2967297
2004-04,Missouri,4433,9766,14199,5988927
2004-04,Montana,1418,3621,5039,989415
2004-04,Nebraska,18,1508,1526,1826341
2004-04,Nevada,2030,2092,4122,2700551
2004-04,New Hampshire,1061,2079,3140,1316470
2004-04,New Jersey,1313,1707,3020,8791894
2004-04,New Mexico,2045,2940,4985,2059179
2004-04,New York,864,8355,9219,19378102
2004-04,North Carolina,154,7637,7791,9535483
2004-04,North Dakota,455,1623,2078,672591
2004-04,Ohio,13048,12000,25048,11536504
2004-04,Oklahoma,4129,5771,9900,3751351
2004-04,Oregon,4199,7670,11869,3831074
2004-04,Pennsylvania,0,40637,40637,12702379
2004-04,Rhode Island,385,334,719,1052567
2004-04,South Carolina,2790,2877,5667,4625364
2004-04,South Dakota,739,2176,2915,814180
2004-04,Tennessee,6668,7055,13723,6346105
2004-04,Texas,11849,17285,29134,25145561
2004-04,Utah,1660,2883,4543,2763885
2004-04,Vermont,574,1109,1683,625741
2004-04,Virginia,5665,7742,13407,8001024
2004-04,Washington,4620,6072,10692,6724540
2004-04,West Virginia,2524,4438,6962,1852994
2004-04,Wisconsin,3960,11819,15779,5686986
2004-04,Wyoming,742,1381,2123,563626
2004-03,Alabama,6557,7570,14127,4779736
2004-03,Arizona,4943,4693,9636,6392017
2004-03,Arkansas,3128,5739,8867,2915918
2004-03,California,15342,16642,31984,37253956
2004-03,Colorado,6364,8437,14801,5029196
2004-03,Connecticut,2450,2216,4666,3574097
2004-03,Delaware,458,743,1201,897934
2004-03,District of Columbia,4,0,4,601723
2004-03,Florida,13066,11065,24131,18801310
2004-03,Georgia,6247,8098,14345,9687653
2004-03,Idaho,1207,2969,4176,1567582
2004-03,Illinois,5652,8860,14512,12830632
2004-03,Indiana,6956,8703,15659,6483802
2004-03,Iowa,34,3595,3629,3046355
2004-03,Kansas,2675,4604,7279,2853118
2004-03,Kentucky,6421,9010,15431,4339367
2004-03,Louisiana,4785,5111,9896,4533372
2004-03,Maine,1422,2542,3964,1328361
2004-03,Maryland,53,3554,3607,5773552
2004-03,Massachusetts,2424,1657,4081,6547629
2004-03,Michigan,3463,13529,16992,9883640
2004-03,Minnesota,4557,10373,14930,5303925
2004-03,Mississippi,3587,4519,8106,2967297
2004-03,Missouri,4877,11280,16157,5988927
2004-03,Montana,1461,3557,5018,989415
2004-03,Nebraska,18,1741,1759,1826341
2004-03,Nevada,2360,2309,4669,2700551
2004-03,New Hampshire,1244,2176,3420,1316470
2004-03,New Jersey,1434,1939,3373,8791894
2004-03,New Mexico,2412,3015,5427,2059179
2004-03,New York,998,8218,9216,19378102
2004-03,North Carolina,184,9598,9782,9535483
2004-03,North Dakota,522,1682,2204,672591
2004-03,Ohio,14932,14278,29210,11536504
2004-03,Oklahoma,4335,6186,10521,3751351
2004-03,Oregon,4876,8346,13222,3831074
2004-03,Pennsylvania,0,49807,49807,12702379
2004-03,Rhode Island,483,440,923,1052567
2004-03,South Carolina,3527,4117,7644,4625364
2004-03,South Dakota,875,2446,3321,814180
2004-03,Tennessee,8586,9401,17987,6346105
2004-03,Texas,13820,19043,32863,25145561
2004-03,Utah,1730,3106,4836,2763885
2004-03,Vermont,663,1155,1818,625741
2004-03,Virginia,7535,9358,16893,8001024
2004-03,Washington,5576,6826,12402,6724540
2004-03,West Virginia,3132,4993,8125,1852994
2004-03,Wisconsin,4974,14036,19010,5686986
2004-03,Wyoming,783,1519,2302,563626
2004-02,Alabama,7436,8649,16085,4779736
2004-02,Arizona,5482,5080,10562,6392017
2004-02,Arkansas,3795,6474,10269,2915918
2004-02,California,14778,16079,30857,37253956
2004-02,Colorado,5491,7180,12671,5029196
2004-02,Connecticut,2260,1986,4246,3574097
2004-02,Delaware,488,742,1230,897934
2004-02,District of Columbia,1,0,1,601723
2004-02,Florida,13072,11921,24993,18801310
2004-02,Georgia,8082,9902,17984,9687653
2004-02,Idaho,1220,2664,3884,1567582
2004-02,Illinois,5436,8184,13620,12830632
2004-02,Indiana,6538,8113,14651,6483802
2004-02,Iowa,33,3149,3182,3046355
2004-02,Kansas,2409,4752,7161,2853118
2004-02,Kentucky,7218,9678,16896,4339367
2004-02,Louisiana,5369,5457,10826,4533372
2004-02,Maine,1047,1952,2999,1328361
2004-02,Maryland,56,3839,3895,5773552
2004-02,Massachusetts,2208,1354,3562,6547629
2004-02,Michigan,2784,12220,15004,9883640
2004-02,Minnesota,3774,7687,11461,5303925
2004-02,Mississippi,4694,5638,10332,2967297
2004-02,Missouri,3435,11182,14617,5988927
2004-02,Montana,1403,2972,4375,989415
2004-02,Nebraska,16,1693,1709,1826341
2004-02,Nevada,2218,2141,4359,2700551
2004-02,New Hampshire,1078,1658,2736,1316470
2004-02,New Jersey,1178,1754,2932,8791894
2004-02,New Mexico,2624,3389,6013,2059179
2004-02,New York,815,6938,7753,19378102
2004-02,North Carolina,203,10798,11001,9535483
2004-02,North Dakota,431,1365,1796,672591
2004-02,Ohio,14570,13324,27894,11536504
2004-02,Oklahoma,5264,7160,12424,3751351
2004-02,Oregon,4340,7361,11701,3831074
2004-02,Pennsylvania,0,39844,39844,12702379
2004-02,Rhode Island,344,384,728,1052567
2004-02,South Carolina,4146,4322,8468,4625364
2004-02,South Dakota,900,2391,3291,814180
2004-02,Tennessee,9005,10213,19218,6346105
2004-02,Texas,15878,21682,37560,25145561
2004-02,Utah,1899,3456,5355,2763885
2004-02,Vermont,538,953,1491,625741
2004-02,Virginia,7757,9311,17068,8001024
2004-02,Washington,5203,6486,11689,6724540
2004-02,West Virginia,3229,4858,8087,1852994
2004-02,Wisconsin,4392,10943,15335,5686986
2004-02,Wyoming,787,1323,2110,563626
2004-01,Alabama,6917,9253,16170,4779736
2004-01,Arizona,4692,4882,9574,6392017
2004-01,Arkansas,3063,6622,9685,2915918
2004-01,California,15308,16138,31446,37253956
2004-01,Colorado,5320,7515,12835,5029196
2004-01,Connecticut,2205,2228,4433,3574097
2004-01,Delaware,413,779,1192,897934
2004-01,District of Columbia,0,0,0,601723
2004-01,Florida,12341,12444,24785,18801310
2004-01,Georgia,6775,9566,16341,9687653
2004-01,Idaho,1060,2211,3271,1567582
2004-01,Illinois,5216,7751,12967,12830632
2004-01,Indiana,6071,8040,14111,6483802
2004-01,Iowa,27,2872,2899,3046355
2004-01,Kansas,2319,4941,7260,2853118
2004-01,Kentucky,6515,9414,15929,4339367
2004-01,Louisiana,4339,6433,10772,4533372
2004-01,Maine,1082,1987,3069,1328361
2004-01,Maryland,61,3185,3246,5773552
2004-01,Massachusetts,1960,1398,3358,6547629
2004-01,Michigan,2450,10514,12964,9883640
2004-01,Minnesota,3431,6430,9861,5303925
2004-01,Mississippi,3384,5481,8865,2967297
2004-01,Missouri,3396,10698,14094,5988927
2004-01,Montana,1125,2444,3569,989415
2004-01,Nebraska,14,1860,1874,1826341
2004-01,Nevada,2080,2053,4133,2700551
2004-01,New Hampshire,1103,1900,3003,1316470
2004-01,New Jersey,1204,1904,3108,8791894
2004-01,New Mexico,2108,2943,5051,2059179
2004-01,New York,993,6345,7338,19378102
2004-01,North Carolina,218,10901,11119,9535483
2004-01,North Dakota,404,1369,1773,672591
2004-01,Ohio,10852,12738,23590,11536504
2004-01,Oklahoma,4326,6882,11208,3751351
2004-01,Oregon,3915,6612,10527,3831074
2004-01,Pennsylvania,0,37717,37717,12702379
2004-01,Rhode Island,344,387,731,1052567
2004-01,South Carolina,3469,4436,7905,4625364
2004-01,South Dakota,694,2141,2835,814180
2004-01,Tennessee,8506,10041,18547,6346105
2004-01,Texas,14105,23163,37268,25145561
2004-01,Utah,1490,2880,4370,2763885
2004-01,Vermont,368,739,1107,625741
2004-01,Virginia,6537,9530,16067,8001024
2004-01,Washington,4479,5873,10352,6724540
2004-01,West Virginia,2758,4887,7645,1852994
2004-01,Wisconsin,3485,8366,11851,5686986
2004-01,Wyoming,636,1286,1922,563626
2003-12,Alabama,7474,24528,32002,4779736
2003-12,Arizona,5503,8313,13816,6392017
2003-12,Arkansas,3545,15259,18804,2915918
2003-12,California,15670,23774,39444,37253956
2003-12,Colorado,6667,12922,19589,5029196
2003-12,Connecticut,2309,3034,5343,3574097
2003-12,Delaware,440,1801,2241,897934
2003-12,District of Columbia,2,0,2,601723
2003-12,Florida,13243,23434,36677,18801310
2003-12,Georgia,7767,23368,31135,9687653
2003-12,Idaho,1444,4939,6383,1567582
2003-12,Illinois,5549,12997,18546,12830632
2003-12,Indiana,5948,15622,21570,6483802
2003-12,Iowa,34,7760,7794,3046355
2003-12,Kansas,2293,9759,12052,2853118
2003-12,Kentucky,7530,20180,27710,4339367
2003-12,Louisiana,5331,18701,24032,4533372
2003-12,Maine,1004,3662,4666,1328361
2003-12,Maryland,46,6658,6704,5773552
2003-12,Massachusetts,1866,1741,3607,6547629
2003-12,Michigan,2790,24013,26803,9883640
2003-12,Minnesota,3733,12368,16101,5303925
2003-12,Mississippi,3764,16441,20205,2967297
2003-12,Missouri,3638,20544,24182,5988927
2003-12,Montana,1675,5057,6732,989415
2003-12,Nebraska,21,4864,4885,1826341
2003-12,Nevada,2187,3465,5652,2700551
2003-12,New Hampshire,1130,2547,3677,1316470
2003-12,New Jersey,1152,2836,3988,8791894
2003-12,New Mexico,2270,5100,7370,2059179
2003-12,New York,626,12525,13151,19378102
2003-12,North Carolina,224,26027,26251,9535483
2003-12,North Dakota,476,2460,2936,672591
2003-12,Ohio,9941,25472,35413,11536504
2003-12,Oklahoma,4872,14608,19480,3751351
2003-12,Oregon,4850,11969,16819,3831074
2003-12,Pennsylvania,0,48476,48476,12702379
2003-12,Rhode Island,306,510,816,1052567
2003-12,South Carolina,3996,11223,15219,4625364
2003-12,South Dakota,825,4184,5009,814180
2003-12,Tennessee,9314,21419,30733,6346105
2003-12,Texas,16771,53068,69839,25145561
2003-12,Utah,2228,7630,9858,2763885
2003-12,Vermont,480,1253,1733,625741
2003-12,Virginia,7625,20025,27650,8001024
2003-12,Washington,5084,10261,15345,6724540
2003-12,West Virginia,3347,9867,13214,1852994
2003-12,Wisconsin,4513,15366,19879,5686986
2003-12,Wyoming,1066,2615,3681,563626
2003-11,Alabama,5181,16188,21369,4779736
2003-11,Arizona,3924,4970,8894,6392017
2003-11,Arkansas,2274,11873,14147,2915918
2003-11,California,13173,18263,31436,37253956
2003-11,Colorado,5104,9144,14248,5029196
2003-11,Connecticut,1714,2835,4549,3574097
2003-11,Delaware,360,1560,1920,897934
2003-11,District of Columbia,1,0,1,601723
2003-11,Florida,10373,15492,25865,18801310
2003-11,Georgia,5179,14026,19205,9687653
2003-11,Idaho,990,3153,4143,1567582
2003-11,Illinois,4628,11333,15961,12830632
2003-11,Indiana,4872,14289,19161,6483802
2003-11,Iowa,16,6792,6808,3046355
2003-11,Kansas,2054,8730,10784,2853118
2003-11,Kentucky,5442,14539,19981,4339367
2003-11,Louisiana,3469,13057,16526,4533372
2003-11,Maine,965,3958,4923,1328361
2003-11,Maryland,53,7057,7110,5773552
2003-11,Massachusetts,1582,1905,3487,6547629
2003-11,Michigan,2189,24735,26924,9883640
2003-11,Minnesota,2736,12900,15636,5303925
2003-11,Mississippi,2700,12967,15667,2967297
2003-11,Missouri,2971,17993,20964,5988927
2003-11,Montana,935,3540,4475,989415
2003-11,Nebraska,13,4235,4248,1826341
2003-11,Nevada,1756,2333,4089,2700551
2003-11,New Hampshire,1027,2730,3757,1316470
2003-11,New Jersey,1172,2849,4021,8791894
2003-11,New Mexico,1614,3480,5094,2059179
2003-11,New York,575,13967,14542,19378102
2003-11,North Carolina,174,18149,18323,9535483
2003-11,North Dakota,338,2547,2885,672591
2003-11,Ohio,7821,24729,32550,11536504
2003-11,Oklahoma,3315,10773,14088,3751351
2003-11,Oregon,3762,7957,11719,3831074
2003-11,Pennsylvania,0,54412,54412,12702379
2003-11,Rhode Island,320,518,838,1052567
2003-11,South Carolina,2778,6824,9602,4625364
2003-11,South Dakota,552,3993,4545,814180
2003-11,Tennessee,7170,15346,22516,6346105
2003-11,Texas,11348,31950,43298,25145561
2003-11,Utah,1551,4317,5868,2763885
2003-11,Vermont,454,1689,2143,625741
2003-11,Virginia,5855,16862,22717,8001024
2003-11,Washington,4094,7070,11164,6724540
2003-11,West Virginia,2282,10165,12447,1852994
2003-11,Wisconsin,3793,18558,22351,5686986
2003-11,Wyoming,631,1608,2239,563626
2003-10,Alabama,5265,11236,16501,4779736
2003-10,Arizona,3910,5315,9225,6392017
2003-10,Arkansas,2403,10053,12456,2915918
2003-10,California,13202,17037,30239,37253956
2003-10,Colorado,5435,10507,15942,5029196
2003-10,Connecticut,2415,3238,5653,3574097
2003-10,Delaware,427,1229,1656,897934
2003-10,District of Columbia,1,0,1,601723
2003-10,Florida,11125,13806,24931,18801310
2003-10,Georgia,5558,14815,20373,9687653
2003-10,Idaho,1002,3977,4979,1567582
2003-10,Illinois,4591,9412,14003,12830632
2003-10,Indiana,5444,10865,16309,6483802
2003-10,Iowa,22,5711,5733,3046355
2003-10,Kansas,2152,6951,9103,2853118
2003-10,Kentucky,5424,13224,18648,4339367
2003-10,Louisiana,3801,12695,16496,4533372
2003-10,Maine,1205,6691,7896,1328361
2003-10,Maryland,50,5279,5329,5773552
2003-10,Massachusetts,1880,1953,3833,6547629
2003-10,Michigan,2524,22569,25093,9883640
2003-10,Minnesota,3398,20092,23490,5303925
2003-10,Mississippi,2782,8624,11406,2967297
2003-10,Missouri,4651,16454,21105,5988927
2003-10,Montana,1361,6379,7740,989415
2003-10,Nebraska,17,3786,3803,1826341
2003-10,Nevada,1920,2298,4218,2700551
2003-10,New Hampshire,1117,3211,4328,1316470
2003-10,New Jersey,1247,2338,3585,8791894
2003-10,New Mexico,2000,3650,5650,2059179
2003-10,New York,703,13798,14501,19378102
2003-10,North Carolina,200,15040,15240,9535483
2003-10,North Dakota,337,4141,4478,672591
2003-10,Ohio,7714,16537,24251,11536504
2003-10,Oklahoma,3509,8890,12399,3751351
2003-10,Oregon,3465,8995,12460,3831074
2003-10,Pennsylvania,1,50591,50592,12702379
2003-10,Rhode Island,360,507,867,1052567
2003-10,South Carolina,2797,5902,8699,4625364
2003-10,South Dakota,583,6168,6751,814180
2003-10,Tennessee,6970,11580,18550,6346105
2003-10,Texas,11617,32404,44021,25145561
2003-10,Utah,1288,4301,5589,2763885
2003-10,Vermont,529,2075,2604,625741
2003-10,Virginia,6184,13713,19897,8001024
2003-10,Washington,4388,8601,12989,6724540
2003-10,West Virginia,2391,9284,11675,1852994
2003-10,Wisconsin,4460,19541,24001,5686986
2003-10,Wyoming,607,1773,2380,563626
2003-09,Alabama,4879,9491,14370,4779736
2003-09,Arizona,4034,5028,9062,6392017
2003-09,Arkansas,2278,7639,9917,2915918
2003-09,California,13216,17304,30520,37253956
2003-09,Colorado,5315,8800,14115,5029196
2003-09,Connecticut,1750,2255,4005,3574097
2003-09,Delaware,382,868,1250,897934
2003-09,District of Columbia,0,0,0,601723
2003-09,Florida,10963,11116,22079,18801310
2003-09,Georgia,5152,10463,15615,9687653
2003-09,Idaho,1119,4247,5366,1567582
2003-09,Illinois,4045,7990,12035,12830632
2003-09,Indiana,1297,4641,5938,6483802
2003-09,Iowa,17,3882,3899,3046355
2003-09,Kansas,1733,5248,6981,2853118
2003-09,Kentucky,4742,9316,14058,4339367
2003-09,Louisiana,3865,9886,13751,4533372
2003-09,Maine,1101,4496,5597,1328361
2003-09,Maryland,71,3833,3904,5773552
2003-09,Massachusetts,1835,1534,3369,6547629
2003-09,Michigan,2212,19309,21521,9883640
2003-09,Minnesota,3457,18529,21986,5303925
2003-09,Mississippi,2567,6019,8586,2967297
2003-09,Missouri,3577,11928,15505,5988927
2003-09,Montana,1235,4878,6113,989415
2003-09,Nebraska,16,2548,2564,1826341
2003-09,Nevada,1632,2012,3644,2700551
2003-09,New Hampshire,1251,2670,3921,1316470
2003-09,New Jersey,1171,1862,3033,8791894
2003-09,New Mexico,1563,3233,4796,2059179
2003-09,New York,673,11066,11739,19378102
2003-09,North Carolina,174,10583,10757,9535483
2003-09,North Dakota,356,3293,3649,672591
2003-09,Ohio,7135,14317,21452,11536504
2003-09,Oklahoma,2909,6795,9704,3751351
2003-09,Oregon,4027,10257,14284,3831074
2003-09,Pennsylvania,0,43246,43246,12702379
2003-09,Rhode Island,307,434,741,1052567
2003-09,South Carolina,2683,5115,7798,4625364
2003-09,South Dakota,633,4100,4733,814180
2003-09,Tennessee,6458,9642,16100,6346105
2003-09,Texas,11235,34575,45810,25145561
2003-09,Utah,1412,4277,5689,2763885
2003-09,Vermont,519,1665,2184,625741
2003-09,Virginia,5033,9747,14780,8001024
2003-09,Washington,3843,7985,11828,6724540
2003-09,West Virginia,2172,5981,8153,1852994
2003-09,Wisconsin,3780,16527,20307,5686986
2003-09,Wyoming,648,1991,2639,563626
2003-08,Alabama,5276,8017,13293,4779736
2003-08,Arizona,3586,5533,9119,6392017
2003-08,Arkansas,2369,5973,8342,2915918
2003-08,California,12887,18847,31734,37253956
2003-08,Colorado,5841,8549,14390,5029196
2003-08,Connecticut,1846,1921,3767,3574097
2003-08,Delaware,378,842,1220,897934
2003-08,District of Columbia,0,0,0,601723
2003-08,Florida,11341,11389,22730,18801310
2003-08,Georgia,5614,9367,14981,9687653
2003-08,Idaho,1026,3036,4062,1567582
2003-08,Illinois,3676,7798,11474,12830632
2003-08,Indiana,1309,4540,5849,6483802
2003-08,Iowa,20,2588,2608,3046355
2003-08,Kansas,1693,4820,6513,2853118
2003-08,Kentucky,4985,9265,14250,4339367
2003-08,Louisiana,3858,7446,11304,4533372
2003-08,Maine,1033,2905,3938,1328361
2003-08,Maryland,59,3700,3759,5773552
2003-08,Massachusetts,1515,1168,2683,6547629
2003-08,Michigan,1951,12482,14433,9883640
2003-08,Minnesota,3541,10999,14540,5303925
2003-08,Mississippi,2792,6380,9172,2967297
2003-08,Missouri,2453,10965,13418,5988927
2003-08,Montana,1330,3493,4823,989415
2003-08,Nebraska,17,2079,2096,1826341
2003-08,Nevada,1985,2275,4260,2700551
2003-08,New Hampshire,1189,2221,3410,1316470
2003-08,New Jersey,1259,1801,3060,8791894
2003-08,New Mexico,1974,3230,5204,2059179
2003-08,New York,590,7318,7908,19378102
2003-08,North Carolina,177,11499,11676,9535483
2003-08,North Dakota,307,2074,2381,672591
2003-08,Ohio,6661,13645,20306,11536504
2003-08,Oklahoma,3683,6759,10442,3751351
2003-08,Oregon,3755,7374,11129,3831074
2003-08,Pennsylvania,0,37474,37474,12702379
2003-08,Rhode Island,298,348,646,1052567
2003-08,South Carolina,2832,5076,7908,4625364
2003-08,South Dakota,544,2922,3466,814180
2003-08,Tennessee,7127,11123,18250,6346105
2003-08,Texas,12032,32370,44402,25145561
2003-08,Utah,1375,3315,4690,2763885
2003-08,Vermont,491,1134,1625,625741
2003-08,Virginia,5851,9346,15197,8001024
2003-08,Washington,4017,6595,10612,6724540
2003-08,West Virginia,2407,4363,6770,1852994
2003-08,Wisconsin,3199,10185,13384,5686986
2003-08,Wyoming,587,1412,1999,563626
2003-07,Alabama,4780,5391,10171,4779736
2003-07,Arizona,3580,3651,7231,6392017
2003-07,Arkansas,2064,3568,5632,2915918
2003-07,California,12906,14736,27642,37253956
2003-07,Colorado,4654,5542,10196,5029196
2003-07,Connecticut,1821,1646,3467,3574097
2003-07,Delaware,357,597,954,897934
2003-07,District of Columbia,3,0,3,601723
2003-07,Florida,9731,8767,18498,18801310
2003-07,Georgia,4862,6014,10876,9687653
2003-07,Idaho,888,1977,2865,1567582
2003-07,Illinois,3376,5435,8811,12830632
2003-07,Indiana,1121,2653,3774,6483802
2003-07,Iowa,25,1545,1570,3046355
2003-07,Kansas,1385,2672,4057,2853118
2003-07,Kentucky,4551,5626,10177,4339367
2003-07,Louisiana,3829,4505,8334,4533372
2003-07,Maine,840,1811,2651,1328361
2003-07,Maryland,65,2531,2596,5773552
2003-07,Massachusetts,1342,1028,2370,6547629
2003-07,Michigan,1832,8405,10237,9883640
2003-07,Minnesota,3476,5959,9435,5303925
2003-07,Mississippi,2525,3351,5876,2967297
2003-07,Missouri,2388,7106,9494,5988927
2003-07,Montana,1167,2483,3650,989415
2003-07,Nebraska,9,1185,1194,1826341
2003-07,Nevada,1776,1638,3414,2700551
2003-07,New Hampshire,950,1512,2462,1316470
2003-07,New Jersey,1255,1480,2735,8791894
2003-07,New Mexico,1680,2435,4115,2059179
2003-07,New York,564,5098,5662,19378102
2003-07,North Carolina,183,7117,7300,9535483
2003-07,North Dakota,286,1260,1546,672591
2003-07,Ohio,5956,9045,15001,11536504
2003-07,Oklahoma,2966,4189,7155,3751351
2003-07,Oregon,3157,5178,8335,3831074
2003-07,Pennsylvania,1,31603,31604,12702379
2003-07,Rhode Island,303,308,611,1052567
2003-07,South Carolina,2421,2835,5256,4625364
2003-07,South Dakota,537,1791,2328,814180
2003-07,Tennessee,6511,6670,13181,6346105
2003-07,Texas,10515,17305,27820,25145561
2003-07,Utah,1232,2521,3753,2763885
2003-07,Vermont,411,700,1111,625741
2003-07,Virginia,5340,6950,12290,8001024
2003-07,Washington,3688,4852,8540,6724540
2003-07,West Virginia,2024,3298,5322,1852994
2003-07,Wisconsin,2711,6562,9273,5686986
2003-07,Wyoming,541,1082,1623,563626
2003-06,Alabama,4881,4840,9721,4779736
2003-06,Arizona,3286,3512,6798,6392017
2003-06,Arkansas,2193,3361,5554,2915918
2003-06,California,12926,15179,28105,37253956
2003-06,Colorado,4844,5938,10782,5029196
2003-06,Connecticut,1890,1724,3614,3574097
2003-06,Delaware,396,599,995,897934
2003-06,District of Columbia,0,0,0,601723
2003-06,Florida,10197,8621,18818,18801310
2003-06,Georgia,4988,5708,10696,9687653
2003-06,Idaho,932,1936,2868,1567582
2003-06,Illinois,3423,4917,8340,12830632
2003-06,Indiana,1191,2773,3964,6483802
2003-06,Iowa,15,1483,1498,3046355
2003-06,Kansas,1619,2631,4250,2853118
2003-06,Kentucky,4442,5509,9951,4339367
2003-06,Louisiana,3689,3749,7438,4533372
2003-06,Maine,852,1572,2424,1328361
2003-06,Maryland,51,2621,2672,5773552
2003-06,Massachusetts,1598,1066,2664,6547629
2003-06,Michigan,1878,8518,10396,9883640
2003-06,Minnesota,3316,5815,9131,5303925
2003-06,Mississippi,2370,2931,5301,2967297
2003-06,Missouri,2247,6745,8992,5988927
2003-06,Montana,1168,2852,4020,989415
2003-06,Nebraska,6,1121,1127,1826341
2003-06,Nevada,1537,1502,3039,2700551
2003-06,New Hampshire,946,1485,2431,1316470
2003-06,New Jersey,1342,1694,3036,8791894
2003-06,New Mexico,1659,2287,3946,2059179
2003-06,New York,532,5150,5682,19378102
2003-06,North Carolina,183,7036,7219,9535483
2003-06,North Dakota,302,1181,1483,672591
2003-06,Ohio,6162,9629,15791,11536504
2003-06,Oklahoma,2961,4057,7018,3751351
2003-06,Oregon,3390,5546,8936,3831074
2003-06,Pennsylvania,0,32385,32385,12702379
2003-06,Rhode Island,309,245,554,1052567
2003-06,South Carolina,2419,2591,5010,4625364
2003-06,South Dakota,541,1740,2281,814180
2003-06,Tennessee,6821,6487,13308,6346105
2003-06,Texas,10791,15749,26540,25145561
2003-06,Utah,1208,2321,3529,2763885
2003-06,Vermont,444,643,1087,625741
2003-06,Virginia,4849,6356,11205,8001024
2003-06,Washington,3494,4983,8477,6724540
2003-06,West Virginia,2058,3204,5262,1852994
2003-06,Wisconsin,2777,6302,9079,5686986
2003-06,Wyoming,602,1085,1687,563626
2003-05,Alabama,5038,4894,9932,4779736
2003-05,Arizona,3829,3671,7500,6392017
2003-05,Arkansas,2345,3385,5730,2915918
2003-05,California,12790,15475,28265,37253956
2003-05,Colorado,5395,6297,11692,5029196
2003-05,Connecticut,2176,1998,4174,3574097
2003-05,Delaware,410,668,1078,897934
2003-05,District of Columbia,0,0,0,601723
2003-05,Florida,10463,8740,19203,18801310
2003-05,Georgia,5149,5705,10854,9687653
2003-05,Idaho,1040,2380,3420,1567582
2003-05,Illinois,4046,5470,9516,12830632
2003-05,Indiana,1388,2875,4263,6483802
2003-05,Iowa,8,1588,1596,3046355
2003-05,Kansas,1503,2859,4362,2853118
2003-05,Kentucky,4825,5779,10604,4339367
2003-05,Louisiana,3708,3602,7310,4533372
2003-05,Maine,965,1900,2865,1328361
2003-05,Maryland,81,2742,2823,5773552
2003-05,Massachusetts,1805,1232,3037,6547629
2003-05,Michigan,2013,9246,11259,9883640
2003-05,Minnesota,3478,5787,9265,5303925
2003-05,Mississippi,2773,2855,5628,2967297
2003-05,Missouri,2568,7361,9929,5988927
2003-05,Montana,1220,3123,4343,989415
2003-05,Nebraska,11,1215,1226,1826341
2003-05,Nevada,1865,1708,3573,2700551
2003-05,New Hampshire,1155,1737,2892,1316470
2003-05,New Jersey,1521,1790,3311,8791894
2003-05,New Mexico,1867,2474,4341,2059179
2003-05,New York,840,5765,6605,19378102
2003-05,North Carolina,199,6913,7112,9535483
2003-05,North Dakota,377,1346,1723,672591
2003-05,Ohio,7040,10300,17340,11536504
2003-05,Oklahoma,3109,4184,7293,3751351
2003-05,Oregon,3675,6415,10090,3831074
2003-05,Pennsylvania,0,36697,36697,12702379
2003-05,Rhode Island,357,317,674,1052567
2003-05,South Carolina,2755,2675,5430,4625364
2003-05,South Dakota,579,1795,2374,814180
2003-05,Tennessee,6585,6410,12995,6346105
2003-05,Texas,11533,16351,27884,25145561
2003-05,Utah,1289,2670,3959,2763885
2003-05,Vermont,465,778,1243,625741
2003-05,Virginia,6093,7371,13464,8001024
2003-05,Washington,4251,5387,9638,6724540
2003-05,West Virginia,2236,3846,6082,1852994
2003-05,Wisconsin,3074,7244,10318,5686986
2003-05,Wyoming,647,1228,1875,563626
2003-04,Alabama,5191,5036,10227,4779736
2003-04,Arizona,4188,3788,7976,6392017
2003-04,Arkansas,2344,3950,6294,2915918
2003-04,California,13667,16560,30227,37253956
2003-04,Colorado,5630,7141,12771,5029196
2003-04,Connecticut,2154,2235,4389,3574097
2003-04,Delaware,477,680,1157,897934
2003-04,District of Columbia,1,0,1,601723
2003-04,Florida,10801,9036,19837,18801310
2003-04,Georgia,4995,5579,10574,9687653
2003-04,Idaho,1068,2730,3798,1567582
2003-04,Illinois,4404,6581,10985,12830632
2003-04,Indiana,1470,3438,4908,6483802
2003-04,Iowa,17,2338,2355,3046355
2003-04,Kansas,1871,3614,5485,2853118
2003-04,Kentucky,4677,7517,12194,4339367
2003-04,Louisiana,3835,3494,7329,4533372
2003-04,Maine,1147,2184,3331,1328361
2003-04,Maryland,53,3307,3360,5773552
2003-04,Massachusetts,1964,1366,3330,6547629
2003-04,Michigan,2247,11257,13504,9883640
2003-04,Minnesota,3013,8812,11825,5303925
2003-04,Mississippi,2724,2992,5716,2967297
2003-04,Missouri,2750,9911,12661,5988927
2003-04,Montana,1397,3470,4867,989415
2003-04,Nebraska,21,1310,1331,1826341
2003-04,Nevada,1753,1967,3720,2700551
2003-04,New Hampshire,1262,2188,3450,1316470
2003-04,New Jersey,1453,1998,3451,8791894
2003-04,New Mexico,1730,2849,4579,2059179
2003-04,New York,892,7714,8606,19378102
2003-04,North Carolina,204,7997,8201,9535483
2003-04,North Dakota,350,1483,1833,672591
2003-04,Ohio,7873,12557,20430,11536504
2003-04,Oklahoma,3653,5336,8989,3751351
2003-04,Oregon,4110,7304,11414,3831074
2003-04,Pennsylvania,0,41427,41427,12702379
2003-04,Rhode Island,372,361,733,1052567
2003-04,South Carolina,2966,2975,5941,4625364
2003-04,South Dakota,671,1902,2573,814180
2003-04,Tennessee,6346,6755,13101,6346105
2003-04,Texas,11189,16365,27554,25145561
2003-04,Utah,1606,2980,4586,2763885
2003-04,Vermont,468,1154,1622,625741
2003-04,Virginia,5386,7671,13057,8001024
2003-04,Washington,4513,6010,10523,6724540
2003-04,West Virginia,2495,4884,7379,1852994
2003-04,Wisconsin,3685,11661,15346,5686986
2003-04,Wyoming,681,1198,1879,563626
2003-03,Alabama,6604,7424,14028,4779736
2003-03,Arizona,4674,4592,9266,6392017
2003-03,Arkansas,3209,5511,8720,2915918
2003-03,California,15102,19430,34532,37253956
2003-03,Colorado,6587,8678,15265,5029196
2003-03,Connecticut,2734,2688,5422,3574097
2003-03,Delaware,529,805,1334,897934
2003-03,District of Columbia,2,0,2,601723
2003-03,Florida,12440,11484,23924,18801310
2003-03,Georgia,6711,8499,15210,9687653
2003-03,Idaho,1277,3027,4304,1567582
2003-03,Illinois,5648,8798,14446,12830632
2003-03,Indiana,2039,4971,7010,6483802
2003-03,Iowa,23,3273,3296,3046355
2003-03,Kansas,2683,4782,7465,2853118
2003-03,Kentucky,6140,9074,15214,4339367
2003-03,Louisiana,5677,5114,10791,4533372
2003-03,Maine,1394,2345,3739,1328361
2003-03,Maryland,90,3816,3906,5773552
2003-03,Massachusetts,2203,1634,3837,6547629
2003-03,Michigan,2723,14080,16803,9883640
2003-03,Minnesota,3907,9836,13743,5303925
2003-03,Mississippi,3781,4824,8605,2967297
2003-03,Missouri,3462,11799,15261,5988927
2003-03,Montana,1620,3417,5037,989415
2003-03,Nebraska,11,1638,1649,1826341
2003-03,Nevada,2559,2331,4890,2700551
2003-03,New Hampshire,1476,2098,3574,1316470
2003-03,New Jersey,1667,2299,3966,8791894
2003-03,New Mexico,2341,3222,5563,2059179
2003-03,New York,930,8418,9348,19378102
2003-03,North Carolina,263,9847,10110,9535483
2003-03,North Dakota,472,1564,2036,672591
2003-03,Ohio,10145,15951,26096,11536504
2003-03,Oklahoma,4060,6182,10242,3751351
2003-03,Oregon,5012,8312,13324,3831074
2003-03,Pennsylvania,0,51962,51962,12702379
2003-03,Rhode Island,387,399,786,1052567
2003-03,South Carolina,3626,4242,7868,4625364
2003-03,South Dakota,849,2463,3312,814180
2003-03,Tennessee,8625,9591,18216,6346105
2003-03,Texas,15167,20186,35353,25145561
2003-03,Utah,1868,3303,5171,2763885
2003-03,Vermont,630,1185,1815,625741
2003-03,Virginia,7622,9514,17136,8001024
2003-03,Washington,5328,7108,12436,6724540
2003-03,West Virginia,3290,5108,8398,1852994
2003-03,Wisconsin,4208,13222,17430,5686986
2003-03,Wyoming,761,1314,2075,563626
2003-02,Alabama,7333,8528,15861,4779736
2003-02,Arizona,5130,4565,9695,6392017
2003-02,Arkansas,3673,6081,9754,2915918
2003-02,California,12325,17170,29495,37253956
2003-02,Colorado,6326,8270,14596,5029196
2003-02,Connecticut,2478,2051,4529,3574097
2003-02,Delaware,442,661,1103,897934
2003-02,District of Columbia,0,0,0,601723
2003-02,Florida,12215,11447,23662,18801310
2003-02,Georgia,7996,10078,18074,9687653
2003-02,Idaho,1230,2651,3881,1567582
2003-02,Illinois,5625,7899,13524,12830632
2003-02,Indiana,1991,4550,6541,6483802
2003-02,Iowa,36,2684,2720,3046355
2003-02,Kansas,2346,4466,6812,2853118
2003-02,Kentucky,7027,9538,16565,4339367
2003-02,Louisiana,5679,5221,10900,4533372
2003-02,Maine,1062,1743,2805,1328361
2003-02,Maryland,81,3582,3663,5773552
2003-02,Massachusetts,1867,1236,3103,6547629
2003-02,Michigan,2496,11718,14214,9883640
2003-02,Minnesota,2793,7133,9926,5303925
2003-02,Mississippi,4472,5373,9845,2967297
2003-02,Missouri,3290,11681,14971,5988927
2003-02,Montana,1223,2582,3805,989415
2003-02,Nebraska,12,1545,1557,1826341
2003-02,Nevada,1916,1984,3900,2700551
2003-02,New Hampshire,1212,1614,2826,1316470
2003-02,New Jersey,1338,1969,3307,8791894
2003-02,New Mexico,2130,3157,5287,2059179
2003-02,New York,878,7132,8010,19378102
2003-02,North Carolina,312,11174,11486,9535483
2003-02,North Dakota,374,1270,1644,672591
2003-02,Ohio,9533,14137,23670,11536504
2003-02,Oklahoma,4464,6925,11389,3751351
2003-02,Oregon,4163,6799,10962,3831074
2003-02,Pennsylvania,0,39530,39530,12702379
2003-02,Rhode Island,374,356,730,1052567
2003-02,South Carolina,4325,4464,8789,4625364
2003-02,South Dakota,836,2158,2994,814180
2003-02,Tennessee,10018,11302,21320,6346105
2003-02,Texas,15836,21130,36966,25145561
2003-02,Utah,1795,3640,5435,2763885
2003-02,Vermont,580,910,1490,625741
2003-02,Virginia,6932,8866,15798,8001024
2003-02,Washington,5077,6342,11419,6724540
2003-02,West Virginia,3044,4715,7759,1852994
2003-02,Wisconsin,3697,9953,13650,5686986
2003-02,Wyoming,685,1268,1953,563626
2003-01,Alabama,6083,8531,14614,4779736
2003-01,Arizona,3990,4064,8054,6392017
2003-01,Arkansas,2733,5854,8587,2915918
2003-01,California,10947,15831,26778,37253956
2003-01,Colorado,5663,7852,13515,5029196
2003-01,Connecticut,2301,2035,4336,3574097
2003-01,Delaware,401,822,1223,897934
2003-01,District of Columbia,1,0,1,601723
2003-01,Florida,11191,11414,22605,18801310
2003-01,Georgia,6096,9087,15183,9687653
2003-01,Idaho,1058,2290,3348,1567582
2003-01,Illinois,4866,7026,11892,12830632
2003-01,Indiana,1703,4007,5710,6483802
2003-01,Iowa,18,2417,2435,3046355
2003-01,Kansas,2363,4944,7307,2853118
2003-01,Kentucky,5871,8597,14468,4339367
2003-01,Louisiana,5257,5970,11227,4533372
2003-01,Maine,964,1691,2655,1328361
2003-01,Maryland,72,3289,3361,5773552
2003-01,Massachusetts,1732,1276,3008,6547629
2003-01,Michigan,2239,10270,12509,9883640
2003-01,Minnesota,2543,5832,8375,5303925
2003-01,Mississippi,3362,5741,9103,2967297
2003-01,Missouri,2904,10557,13461,5988927
2003-01,Montana,1077,2463,3540,989415
2003-01,Nebraska,15,1818,1833,1826341
2003-01,Nevada,1806,1868,3674,2700551
2003-01,New Hampshire,1175,1677,2852,1316470
2003-01,New Jersey,1421,2206,3627,8791894
2003-01,New Mexico,1771,2781,4552,2059179
2003-01,New York,846,5742,6588,19378102
2003-01,North Carolina,200,10455,10655,9535483
2003-01,North Dakota,370,1186,1556,672591
2003-01,Ohio,7269,11867,19136,11536504
2003-01,Oklahoma,3701,6139,9840,3751351
2003-01,Oregon,3921,6204,10125,3831074
2003-01,Pennsylvania,0,38600,38600,12702379
2003-01,Rhode Island,317,396,713,1052567
2003-01,South Carolina,3378,4271,7649,4625364
2003-01,South Dakota,684,2086,2770,814180
2003-01,Tennessee,8062,9711,17773,6346105
2003-01,Texas,13123,21251,34374,25145561
2003-01,Utah,1347,2923,4270,2763885
2003-01,Vermont,375,655,1030,625741
2003-01,Virginia,6112,8780,14892,8001024
2003-01,Washington,4433,5721,10154,6724540
2003-01,West Virginia,2512,4294,6806,1852994
2003-01,Wisconsin,3306,7656,10962,5686986
2003-01,Wyoming,563,1173,1736,563626
2002-12,Alabama,6610,23501,30111,4779736
2002-12,Arizona,4580,7397,11977,6392017
2002-12,Arkansas,2997,14348,17345,2915918
2002-12,California,32200,28706,60906,37253956
2002-12,Colorado,6063,13489,19552,5029196
2002-12,Connecticut,2096,2664,4760,3574097
2002-12,Delaware,434,1771,2205,897934
2002-12,District of Columbia,1,0,1,601723
2002-12,Florida,11754,22425,34179,18801310
2002-12,Georgia,7289,22668,29957,9687653
2002-12,Idaho,1366,4665,6031,1567582
2002-12,Illinois,5310,12200,17510,12830632
2002-12,Indiana,1887,9930,11817,6483802
2002-12,Iowa,29,6586,6615,3046355
2002-12,Kansas,2358,10014,12372,2853118
2002-12,Kentucky,7163,19662,26825,4339367
2002-12,Louisiana,4647,17613,22260,4533372
2002-12,Maine,1033,3601,4634,1328361
2002-12,Maryland,63,6423,6486,5773552
2002-12,Massachusetts,1518,1611,3129,6547629
2002-12,Michigan,2353,22251,24604,9883640
2002-12,Minnesota,2692,10906,13598,5303925
2002-12,Mississippi,3646,15941,19587,2967297
2002-12,Missouri,3010,20492,23502,5988927
2002-12,Montana,1341,4476,5817,989415
2002-12,Nebraska,18,4528,4546,1826341
2002-12,Nevada,1918,3187,5105,2700551
2002-12,New Hampshire,1169,2552,3721,1316470
2002-12,New Jersey,1256,2893,4149,8791894
2002-12,New Mexico,2108,4997,7105,2059179
2002-12,New York,566,11725,12291,19378102
2002-12,North Carolina,220,24297,24517,9535483
2002-12,North Dakota,397,2386,2783,672591
2002-12,Ohio,9380,25337,34717,11536504
2002-12,Oklahoma,4039,13459,17498,3751351
2002-12,Oregon,4269,11488,15757,3831074
2002-12,Pennsylvania,0,50168,50168,12702379
2002-12,Rhode Island,281,479,760,1052567
2002-12,South Carolina,3649,11454,15103,4625364
2002-12,South Dakota,782,3933,4715,814180
2002-12,Tennessee,9252,22229,31481,6346105
2002-12,Texas,14673,51750,66423,25145561
2002-12,Utah,2082,7450,9532,2763885
2002-12,Vermont,437,1280,1717,625741
2002-12,Virginia,6758,18489,25247,8001024
2002-12,Washington,4359,9585,13944,6724540
2002-12,West Virginia,3464,9895,13359,1852994
2002-12,Wisconsin,3658,13156,16814,5686986
2002-12,Wyoming,800,2292,3092,563626
2002-11,Alabama,5226,16567,21793,4779736
2002-11,Arizona,3623,4787,8410,6392017
2002-11,Arkansas,2265,12580,14845,2915918
2002-11,California,21645,22253,43898,37253956
2002-11,Colorado,5378,11374,16752,5029196
2002-11,Connecticut,2002,3014,5016,3574097
2002-11,Delaware,403,1638,2041,897934
2002-11,District of Columbia,0,0,0,601723
2002-11,Florida,10420,16300,26720,18801310
2002-11,Georgia,5343,14818,20161,9687653
2002-11,Idaho,892,3142,4034,1567582
2002-11,Illinois,4435,11067,15502,12830632
2002-11,Indiana,1483,10101,11584,6483802
2002-11,Iowa,32,6103,6135,3046355
2002-11,Kansas,2088,9391,11479,2853118
2002-11,Kentucky,5241,15896,21137,4339367
2002-11,Louisiana,3724,13670,17394,4533372
2002-11,Maine,879,3670,4549,1328361
2002-11,Maryland,62,7098,7160,5773552
2002-11,Massachusetts,1588,1882,3470,6547629
2002-11,Michigan,1750,25412,27162,9883640
2002-11,Minnesota,1993,11860,13853,5303925
2002-11,Mississippi,2857,13544,16401,2967297
2002-11,Missouri,2387,18575,20962,5988927
2002-11,Montana,992,3638,4630,989415
2002-11,Nebraska,7,3918,3925,1826341
2002-11,Nevada,1644,2227,3871,2700551
2002-11,New Hampshire,1040,2726,3766,1316470
2002-11,New Jersey,1284,3200,4484,8791894
2002-11,New Mexico,1608,3882,5490,2059179
2002-11,New York,592,14134,14726,19378102
2002-11,North Carolina,214,18178,18392,9535483
2002-11,North Dakota,326,2479,2805,672591
2002-11,Ohio,7939,25864,33803,11536504
2002-11,Oklahoma,2973,10753,13726,3751351
2002-11,Oregon,3581,7807,11388,3831074
2002-11,Pennsylvania,0,61455,61455,12702379
2002-11,Rhode Island,344,495,839,1052567
2002-11,South Carolina,2843,7295,10138,4625364
2002-11,South Dakota,641,3835,4476,814180
2002-11,Tennessee,8047,17707,25754,6346105
2002-11,Texas,11955,35618,47573,25145561
2002-11,Utah,1327,4727,6054,2763885
2002-11,Vermont,393,1835,2228,625741
2002-11,Virginia,5725,16402,22127,8001024
2002-11,Washington,4051,7273,11324,6724540
2002-11,West Virginia,2536,10929,13465,1852994
2002-11,Wisconsin,3452,16555,20007,5686986
2002-11,Wyoming,532,1703,2235,563626
2002-10,Alabama,5174,10495,15669,4779736
2002-10,Arizona,3595,5172,8767,6392017
2002-10,Arkansas,2495,9816,12311,2915918
2002-10,California,18527,21054,39581,37253956
2002-10,Colorado,5487,12352,17839,5029196
2002-10,Connecticut,2532,3359,5891,3574097
2002-10,Delaware,463,1282,1745,897934
2002-10,District of Columbia,0,0,0,601723
2002-10,Florida,11108,13511,24619,18801310
2002-10,Georgia,5667,14075,19742,9687653
2002-10,Idaho,930,4024,4954,1567582
2002-10,Illinois,4456,9777,14233,12830632
2002-10,Indiana,1653,7308,8961,6483802
2002-10,Iowa,14,5187,5201,3046355
2002-10,Kansas,2012,7229,9241,2853118
2002-10,Kentucky,5120,12837,17957,4339367
2002-10,Louisiana,3878,11092,14970,4533372
2002-10,Maine,1188,6408,7596,1328361
2002-10,Maryland,55,5540,5595,5773552
2002-10,Massachusetts,1719,1875,3594,6547629
2002-10,Michigan,2071,22792,24863,9883640
2002-10,Minnesota,2340,17425,19765,5303925
2002-10,Mississippi,2743,8029,10772,2967297
2002-10,Missouri,2618,17189,19807,5988927
2002-10,Montana,1172,5908,7080,989415
2002-10,Nebraska,13,3652,3665,1826341
2002-10,Nevada,1894,2312,4206,2700551
2002-10,New Hampshire,1239,3335,4574,1316470
2002-10,New Jersey,1322,2583,3905,8791894
2002-10,New Mexico,1961,4024,5985,2059179
2002-10,New York,621,14158,14779,19378102
2002-10,North Carolina,213,14468,14681,9535483
2002-10,North Dakota,327,3728,4055,672591
2002-10,Ohio,7660,19222,26882,11536504
2002-10,Oklahoma,3412,8485,11897,3751351
2002-10,Oregon,3423,8527,11950,3831074
2002-10,Pennsylvania,0,57986,57986,12702379
2002-10,Rhode Island,344,541,885,1052567
2002-10,South Carolina,2668,5596,8264,4625364
2002-10,South Dakota,559,5404,5963,814180
2002-10,Tennessee,7362,12112,19474,6346105
2002-10,Texas,11678,33839,45517,25145561
2002-10,Utah,1228,4630,5858,2763885
2002-10,Vermont,480,2074,2554,625741
2002-10,Virginia,6792,13444,20236,8001024
2002-10,Washington,3791,8363,12154,6724540
2002-10,West Virginia,2680,9080,11760,1852994
2002-10,Wisconsin,3694,17404,21098,5686986
2002-10,Wyoming,609,1885,2494,563626
2002-09,Alabama,4762,9589,14351,4779736
2002-09,Arizona,3630,4820,8450,6392017
2002-09,Arkansas,2105,7131,9236,2915918
2002-09,California,16538,20960,37498,37253956
2002-09,Colorado,5421,10240,15661,5029196
2002-09,Connecticut,1784,2180,3964,3574097
2002-09,Delaware,336,973,1309,897934
2002-09,District of Columbia,0,0,0,601723
2002-09,Florida,10087,11020,21107,18801310
2002-09,Georgia,5095,10755,15850,9687653
2002-09,Idaho,1101,4130,5231,1567582
2002-09,Illinois,3479,7569,11048,12830632
2002-09,Indiana,1201,4811,6012,6483802
2002-09,Iowa,18,3558,3576,3046355
2002-09,Kansas,1704,5039,6743,2853118
2002-09,Kentucky,4741,9587,14328,4339367
2002-09,Louisiana,4019,9186,13205,4533372
2002-09,Maine,1215,4580,5795,1328361
2002-09,Maryland,58,4222,4280,5773552
2002-09,Massachusetts,1194,1301,2495,6547629
2002-09,Michigan,1913,19545,21458,9883640
2002-09,Minnesota,2280,16964,19244,5303925
2002-09,Mississippi,2555,5969,8524,2967297
2002-09,Missouri,2380,11189,13569,5988927
2002-09,Montana,1293,4603,5896,989415
2002-09,Nebraska,16,2240,2256,1826341
2002-09,Nevada,1659,2029,3688,2700551
2002-09,New Hampshire,1111,2567,3678,1316470
2002-09,New Jersey,1133,1926,3059,8791894
2002-09,New Mexico,1529,3172,4701,2059179
2002-09,New York,614,11156,11770,19378102
2002-09,North Carolina,210,11182,11392,9535483
2002-09,North Dakota,336,2940,3276,672591
2002-09,Ohio,7064,16062,23126,11536504
2002-09,Oklahoma,2875,6396,9271,3751351
2002-09,Oregon,3724,10604,14328,3831074
2002-09,Pennsylvania,0,47082,47082,12702379
2002-09,Rhode Island,318,411,729,1052567
2002-09,South Carolina,2619,5312,7931,4625364
2002-09,South Dakota,558,3656,4214,814180
2002-09,Tennessee,6368,9989,16357,6346105
2002-09,Texas,10542,34910,45452,25145561
2002-09,Utah,1215,4328,5543,2763885
2002-09,Vermont,480,1520,2000,625741
2002-09,Virginia,5287,10484,15771,8001024
2002-09,Washington,3587,7712,11299,6724540
2002-09,West Virginia,2393,6584,8977,1852994
2002-09,Wisconsin,3277,14561,17838,5686986
2002-09,Wyoming,642,1852,2494,563626
2002-08,Alabama,5352,8158,13510,4779736
2002-08,Arizona,4300,5738,10038,6392017
2002-08,Arkansas,2397,6161,8558,2915918
2002-08,California,18267,22782,41049,37253956
2002-08,Colorado,6151,10100,16251,5029196
2002-08,Connecticut,1873,1922,3795,3574097
2002-08,Delaware,365,879,1244,897934
2002-08,District of Columbia,0,0,0,601723
2002-08,Florida,11087,10848,21935,18801310
2002-08,Georgia,5403,9388,14791,9687653
2002-08,Idaho,1210,3300,4510,1567582
2002-08,Illinois,3724,7809,11533,12830632
2002-08,Indiana,1440,4586,6026,6483802
2002-08,Iowa,12,2351,2363,3046355
2002-08,Kansas,1831,4693,6524,2853118
2002-08,Kentucky,5337,9644,14981,4339367
2002-08,Louisiana,5586,7314,12900,4533372
2002-08,Maine,1074,2591,3665,1328361
2002-08,Maryland,56,3724,3780,5773552
2002-08,Massachusetts,1336,1068,2404,6547629
2002-08,Michigan,1910,12446,14356,9883640
2002-08,Minnesota,2293,11335,13628,5303925
2002-08,Mississippi,2975,6477,9452,2967297
2002-08,Missouri,2490,11034,13524,5988927
2002-08,Montana,1241,3650,4891,989415
2002-08,Nebraska,9,1811,1820,1826341
2002-08,Nevada,1913,1932,3845,2700551
2002-08,New Hampshire,1151,2109,3260,1316470
2002-08,New Jersey,1323,1868,3191,8791894
2002-08,New Mexico,2011,3074,5085,2059179
2002-08,New York,528,6931,7459,19378102
2002-08,North Carolina,210,12041,12251,9535483
2002-08,North Dakota,306,1971,2277,672591
2002-08,Ohio,6508,16232,22740,11536504
2002-08,Oklahoma,3232,6410,9642,3751351
2002-08,Oregon,3629,7222,10851,3831074
2002-08,Pennsylvania,0,43358,43358,12702379
2002-08,Rhode Island,339,346,685,1052567
2002-08,South Carolina,2801,5543,8344,4625364
2002-08,South Dakota,604,2912,3516,814180
2002-08,Tennessee,7298,11242,18540,6346105
2002-08,Texas,11118,32655,43773,25145561
2002-08,Utah,1270,3328,4598,2763885
2002-08,Vermont,435,994,1429,625741
2002-08,Virginia,5622,9400,15022,8001024
2002-08,Washington,3518,6195,9713,6724540
2002-08,West Virginia,2374,4767,7141,1852994
2002-08,Wisconsin,2993,9764,12757,5686986
2002-08,Wyoming,700,1562,2262,563626
2002-07,Alabama,4580,5127,9707,4779736
2002-07,Arizona,4222,4156,8378,6392017
2002-07,Arkansas,2027,3648,5675,2915918
2002-07,California,17115,19476,36591,37253956
2002-07,Colorado,4711,6852,11563,5029196
2002-07,Connecticut,1650,1530,3180,3574097
2002-07,Delaware,370,573,943,897934
2002-07,District of Columbia,0,0,0,601723
2002-07,Florida,9898,8128,18026,18801310
2002-07,Georgia,4694,6005,10699,9687653
2002-07,Idaho,846,2065,2911,1567582
2002-07,Illinois,3597,5341,8938,12830632
2002-07,Indiana,1214,2648,3862,6483802
2002-07,Iowa,43,1426,1469,3046355
2002-07,Kansas,1434,2486,3920,2853118
2002-07,Kentucky,4394,5775,10169,4339367
2002-07,Louisiana,3916,4147,8063,4533372
2002-07,Maine,818,1729,2547,1328361
2002-07,Maryland,46,2670,2716,5773552
2002-07,Massachusetts,1056,855,1911,6547629
2002-07,Michigan,1800,8182,9982,9883640
2002-07,Minnesota,1747,5753,7500,5303925
2002-07,Mississippi,2541,3191,5732,2967297
2002-07,Missouri,2144,6982,9126,5988927
2002-07,Montana,1149,2464,3613,989415
2002-07,Nebraska,16,1282,1298,1826341
2002-07,Nevada,1652,1570,3222,2700551
2002-07,New Hampshire,916,1544,2460,1316470
2002-07,New Jersey,1293,1456,2749,8791894
2002-07,New Mexico,1678,2498,4176,2059179
2002-07,New York,554,4958,5512,19378102
2002-07,North Carolina,172,6973,7145,9535483
2002-07,North Dakota,294,1162,1456,672591
2002-07,Ohio,5361,10352,15713,11536504
2002-07,Oklahoma,2781,4033,6814,3751351
2002-07,Oregon,2837,5185,8022,3831074
2002-07,Pennsylvania,0,37547,37547,12702379
2002-07,Rhode Island,323,291,614,1052567
2002-07,South Carolina,2322,2805,5127,4625364
2002-07,South Dakota,422,1585,2007,814180
2002-07,Tennessee,6561,6462,13023,6346105
2002-07,Texas,10347,17005,27352,25145561
2002-07,Utah,1227,2298,3525,2763885
2002-07,Vermont,411,729,1140,625741
2002-07,Virginia,4941,6839,11780,8001024
2002-07,Washington,3191,4701,7892,6724540
2002-07,West Virginia,2201,3462,5663,1852994
2002-07,Wisconsin,2248,5824,8072,5686986
2002-07,Wyoming,549,1092,1641,563626
2002-06,Alabama,4697,4811,9508,4779736
2002-06,Arizona,4088,3720,7808,6392017
2002-06,Arkansas,2149,3189,5338,2915918
2002-06,California,17283,19266,36549,37253956
2002-06,Colorado,4409,6049,10458,5029196
2002-06,Connecticut,1856,1604,3460,3574097
2002-06,Delaware,342,523,865,897934
2002-06,District of Columbia,1,0,1,601723
2002-06,Florida,10500,8361,18861,18801310
2002-06,Georgia,5051,5442,10493,9687653
2002-06,Idaho,949,2046,2995,1567582
2002-06,Illinois,3439,4551,7990,12830632
2002-06,Indiana,1222,2672,3894,6483802
2002-06,Iowa,22,1291,1313,3046355
2002-06,Kansas,1500,2370,3870,2853118
2002-06,Kentucky,4455,5272,9727,4339367
2002-06,Louisiana,3566,3677,7243,4533372
2002-06,Maine,788,1536,2324,1328361
2002-06,Maryland,35,2626,2661,5773552
2002-06,Massachusetts,1351,953,2304,6547629
2002-06,Michigan,1822,7922,9744,9883640
2002-06,Minnesota,1784,5318,7102,5303925
2002-06,Mississippi,2461,2818,5279,2967297
2002-06,Missouri,2130,6421,8551,5988927
2002-06,Montana,1066,2655,3721,989415
2002-06,Nebraska,10,1021,1031,1826341
2002-06,Nevada,1515,1472,2987,2700551
2002-06,New Hampshire,1008,1541,2549,1316470
2002-06,New Jersey,1438,1511,2949,8791894
2002-06,New Mexico,1682,2374,4056,2059179
2002-06,New York,584,5060,5644,19378102
2002-06,North Carolina,133,6879,7012,9535483
2002-06,North Dakota,276,1284,1560,672591
2002-06,Ohio,5793,8325,14118,11536504
2002-06,Oklahoma,2534,3859,6393,3751351
2002-06,Oregon,3399,5805,9204,3831074
2002-06,Pennsylvania,0,35335,35335,12702379
2002-06,Rhode Island,329,272,601,1052567
2002-06,South Carolina,2417,2446,4863,4625364
2002-06,South Dakota,404,1517,1921,814180
2002-06,Tennessee,6074,5782,11856,6346105
2002-06,Texas,10251,15598,25849,25145561
2002-06,Utah,1241,2303,3544,2763885
2002-06,Vermont,408,615,1023,625741
2002-06,Virginia,4499,6162,10661,8001024
2002-06,Washington,3110,4570,7680,6724540
2002-06,West Virginia,1963,3125,5088,1852994
2002-06,Wisconsin,2560,5752,8312,5686986
2002-06,Wyoming,637,1194,1831,563626
2002-05,Alabama,5012,4850,9862,4779736
2002-05,Arizona,4850,4271,9121,6392017
2002-05,Arkansas,2264,3509,5773,2915918
2002-05,California,18817,19929,38746,37253956
2002-05,Colorado,5386,6690,12076,5029196
2002-05,Connecticut,2004,1734,3738,3574097
2002-05,Delaware,386,629,1015,897934
2002-05,District of Columbia,2,0,2,601723
2002-05,Florida,10309,7780,18089,18801310
2002-05,Georgia,5145,5388,10533,9687653
2002-05,Idaho,1094,2527,3621,1567582
2002-05,Illinois,3932,5111,9043,12830632
2002-05,Indiana,1375,2725,4100,6483802
2002-05,Iowa,13,1369,1382,3046355
2002-05,Kansas,1590,2680,4270,2853118
2002-05,Kentucky,4805,5534,10339,4339367
2002-05,Louisiana,3650,3459,7109,4533372
2002-05,Maine,928,1649,2577,1328361
2002-05,Maryland,47,2438,2485,5773552
2002-05,Massachusetts,1390,949,2339,6547629
2002-05,Michigan,1926,8800,10726,9883640
2002-05,Minnesota,2090,5707,7797,5303925
2002-05,Mississippi,2620,2725,5345,2967297
2002-05,Missouri,2628,7200,9828,5988927
2002-05,Montana,1274,3060,4334,989415
2002-05,Nebraska,21,1109,1130,1826341
2002-05,Nevada,1861,1651,3512,2700551
2002-05,New Hampshire,1036,1689,2725,1316470
2002-05,New Jersey,1611,1764,3375,8791894
2002-05,New Mexico,1885,2518,4403,2059179
2002-05,New York,718,5995,6713,19378102
2002-05,North Carolina,130,6705,6835,9535483
2002-05,North Dakota,359,1256,1615,672591
2002-05,Ohio,6850,8397,15247,11536504
2002-05,Oklahoma,2936,4136,7072,3751351
2002-05,Oregon,3436,5932,9368,3831074
2002-05,Pennsylvania,0,39483,39483,12702379
2002-05,Rhode Island,340,321,661,1052567
2002-05,South Carolina,2566,2630,5196,4625364
2002-05,South Dakota,522,1714,2236,814180
2002-05,Tennessee,6794,6221,13015,6346105
2002-05,Texas,10594,15453,26047,25145561
2002-05,Utah,1422,2534,3956,2763885
2002-05,Vermont,482,869,1351,625741
2002-05,Virginia,5111,6436,11547,8001024
2002-05,Washington,3435,4812,8247,6724540
2002-05,West Virginia,2349,3545,5894,1852994
2002-05,Wisconsin,2869,6814,9683,5686986
2002-05,Wyoming,643,1223,1866,563626
2002-04,Alabama,4845,5073,9918,4779736
2002-04,Arizona,4951,4322,9273,6392017
2002-04,Arkansas,2377,4072,6449,2915918
2002-04,California,18826,20276,39102,37253956
2002-04,Colorado,5541,7774,13315,5029196
2002-04,Connecticut,1968,1863,3831,3574097
2002-04,Delaware,389,675,1064,897934
2002-04,District of Columbia,1,0,1,601723
2002-04,Florida,10388,7910,18298,18801310
2002-04,Georgia,5020,5769,10789,9687653
2002-04,Idaho,1187,2669,3856,1567582
2002-04,Illinois,4580,6652,11232,12830632
2002-04,Indiana,1514,3397,4911,6483802
2002-04,Iowa,40,2354,2394,3046355
2002-04,Kansas,1687,3235,4922,2853118
2002-04,Kentucky,4895,7831,12726,4339367
2002-04,Louisiana,3580,3432,7012,4533372
2002-04,Maine,1135,2095,3230,1328361
2002-04,Maryland,49,3018,3067,5773552
2002-04,Massachusetts,1525,1113,2638,6547629
2002-04,Michigan,2182,11239,13421,9883640
2002-04,Minnesota,2723,9739,12462,5303925
2002-04,Mississippi,3028,2978,6006,2967297
2002-04,Missouri,2740,10273,13013,5988927
2002-04,Montana,1492,3432,4924,989415
2002-04,Nebraska,13,1388,1401,1826341
2002-04,Nevada,1757,1728,3485,2700551
2002-04,New Hampshire,1194,2060,3254,1316470
2002-04,New Jersey,1750,1804,3554,8791894
2002-04,New Mexico,1818,2644,4462,2059179
2002-04,New York,953,7913,8866,19378102
2002-04,North Carolina,116,7449,7565,9535483
2002-04,North Dakota,392,1532,1924,672591
2002-04,Ohio,8344,11275,19619,11536504
2002-04,Oklahoma,3769,5428,9197,3751351
2002-04,Oregon,4020,7405,11425,3831074
2002-04,Pennsylvania,0,45689,45689,12702379
2002-04,Rhode Island,334,318,652,1052567
2002-04,South Carolina,2683,2807,5490,4625364
2002-04,South Dakota,663,2061,2724,814180
2002-04,Tennessee,6676,6869,13545,6346105
2002-04,Texas,11297,16289,27586,25145561
2002-04,Utah,1455,2875,4330,2763885
2002-04,Vermont,529,1294,1823,625741
2002-04,Virginia,5526,7597,13123,8001024
2002-04,Washington,3761,5277,9038,6724540
2002-04,West Virginia,2458,4852,7310,1852994
2002-04,Wisconsin,3338,11381,14719,5686986
2002-04,Wyoming,684,1266,1950,563626
2002-03,Alabama,6313,7433,13746,4779736
2002-03,Arizona,5481,5122,10603,6392017
2002-03,Arkansas,3140,6114,9254,2915918
2002-03,California,19394,23117,42511,37253956
2002-03,Colorado,6547,8870,15417,5029196
2002-03,Connecticut,2475,2229,4704,3574097
2002-03,Delaware,412,842,1254,897934
2002-03,District of Columbia,1,0,1,601723
2002-03,Florida,11307,9916,21223,18801310
2002-03,Georgia,6443,8788,15231,9687653
2002-03,Idaho,1191,3033,4224,1567582
2002-03,Illinois,5583,8184,13767,12830632
2002-03,Indiana,2043,4586,6629,6483802
2002-03,Iowa,19,3055,3074,3046355
2002-03,Kansas,2340,4166,6506,2853118
2002-03,Kentucky,6439,9762,16201,4339367
2002-03,Louisiana,4754,4718,9472,4533372
2002-03,Maine,1290,2488,3778,1328361
2002-03,Maryland,49,3457,3506,5773552
2002-03,Massachusetts,1914,1479,3393,6547629
2002-03,Michigan,2250,13241,15491,9883640
2002-03,Minnesota,3101,9120,12221,5303925
2002-03,Mississippi,3550,5021,8571,2967297
2002-03,Missouri,3362,11988,15350,5988927
2002-03,Montana,1406,2948,4354,989415
2002-03,Nebraska,7,1666,1673,1826341
2002-03,Nevada,2284,2220,4504,2700551
2002-03,New Hampshire,1392,2161,3553,1316470
2002-03,New Jersey,1935,2150,4085,8791894
2002-03,New Mexico,2374,3457,5831,2059179
2002-03,New York,822,7743,8565,19378102
2002-03,North Carolina,151,9843,9994,9535483
2002-03,North Dakota,429,1626,2055,672591
2002-03,Ohio,9328,13407,22735,11536504
2002-03,Oklahoma,3855,5867,9722,3751351
2002-03,Oregon,4308,7810,12118,3831074
2002-03,Pennsylvania,0,53211,53211,12702379
2002-03,Rhode Island,367,405,772,1052567
2002-03,South Carolina,3318,4422,7740,4625364
2002-03,South Dakota,739,2374,3113,814180
2002-03,Tennessee,9044,10275,19319,6346105
2002-03,Texas,13566,19397,32963,25145561
2002-03,Utah,1445,3424,4869,2763885
2002-03,Vermont,607,1488,2095,625741
2002-03,Virginia,6610,8722,15332,8001024
2002-03,Washington,3688,5802,9490,6724540
2002-03,West Virginia,3365,5577,8942,1852994
2002-03,Wisconsin,3966,13497,17463,5686986
2002-03,Wyoming,801,1355,2156,563626
2002-02,Alabama,6773,7616,14389,4779736
2002-02,Arizona,5623,5392,11015,6392017
2002-02,Arkansas,3495,5946,9441,2915918
2002-02,California,17919,19590,37509,37253956
2002-02,Colorado,5733,8122,13855,5029196
2002-02,Connecticut,2233,1900,4133,3574097
2002-02,Delaware,444,749,1193,897934
2002-02,District of Columbia,0,0,0,601723
2002-02,Florida,11955,10681,22636,18801310
2002-02,Georgia,7538,9552,17090,9687653
2002-02,Idaho,1146,2577,3723,1567582
2002-02,Illinois,5142,7695,12837,12830632
2002-02,Indiana,2221,4285,6506,6483802
2002-02,Iowa,17,2591,2608,3046355
2002-02,Kansas,2174,3722,5896,2853118
2002-02,Kentucky,7105,9718,16823,4339367
2002-02,Louisiana,5049,4766,9815,4533372
2002-02,Maine,1062,1838,2900,1328361
2002-02,Maryland,58,3555,3613,5773552
2002-02,Massachusetts,1490,1160,2650,6547629
2002-02,Michigan,1649,11591,13240,9883640
2002-02,Minnesota,2466,6389,8855,5303925
2002-02,Mississippi,4779,5304,10083,2967297
2002-02,Missouri,3101,11294,14395,5988927
2002-02,Montana,1132,2413,3545,989415
2002-02,Nebraska,20,1567,1587,1826341
2002-02,Nevada,1901,1827,3728,2700551
2002-02,New Hampshire,1132,1674,2806,1316470
2002-02,New Jersey,1659,1787,3446,8791894
2002-02,New Mexico,1970,3042,5012,2059179
2002-02,New York,626,7067,7693,19378102
2002-02,North Carolina,192,10530,10722,9535483
2002-02,North Dakota,343,1249,1592,672591
2002-02,Ohio,9070,12255,21325,11536504
2002-02,Oklahoma,4299,6208,10507,3751351
2002-02,Oregon,3610,6791,10401,3831074
2002-02,Pennsylvania,0,43342,43342,12702379
2002-02,Rhode Island,347,328,675,1052567
2002-02,South Carolina,3963,4147,8110,4625364
2002-02,South Dakota,706,1995,2701,814180
2002-02,Tennessee,9553,10435,19988,6346105
2002-02,Texas,13663,19485,33148,25145561
2002-02,Utah,1503,3102,4605,2763885
2002-02,Vermont,570,1065,1635,625741
2002-02,Virginia,6606,8596,15202,8001024
2002-02,Washington,3494,5255,8749,6724540
2002-02,West Virginia,3231,5184,8415,1852994
2002-02,Wisconsin,3652,10052,13704,5686986
2002-02,Wyoming,665,1318,1983,563626
2002-01,Alabama,5950,8119,14069,4779736
2002-01,Arizona,4890,5009,9899,6392017
2002-01,Arkansas,2737,5676,8413,2915918
2002-01,California,18590,19914,38504,37253956
2002-01,Colorado,5951,8788,14739,5029196
2002-01,Connecticut,2207,2082,4289,3574097
2002-01,Delaware,423,811,1234,897934
2002-01,District of Columbia,0,1,1,601723
2002-01,Florida,10907,10289,21196,18801310
2002-01,Georgia,5972,9005,14977,9687653
2002-01,Idaho,1028,2259,3287,1567582
2002-01,Illinois,4885,7347,12232,12830632
2002-01,Indiana,1901,4202,6103,6483802
2002-01,Iowa,24,2367,2391,3046355
2002-01,Kansas,2146,4234,6380,2853118
2002-01,Kentucky,6125,8785,14910,4339367
2002-01,Louisiana,3746,5420,9166,4533372
2002-01,Maine,969,1815,2784,1328361
2002-01,Maryland,72,3198,3270,5773552
2002-01,Massachusetts,1694,1240,2934,6547629
2002-01,Michigan,1582,10486,12068,9883640
2002-01,Minnesota,2517,5800,8317,5303925
2002-01,Mississippi,3220,5080,8300,2967297
2002-01,Missouri,3085,10319,13404,5988927
2002-01,Montana,1037,2574,3611,989415
2002-01,Nebraska,29,1704,1733,1826341
2002-01,Nevada,1958,1742,3700,2700551
2002-01,New Hampshire,1249,1764,3013,1316470
2002-01,New Jersey,1643,2054,3697,8791894
2002-01,New Mexico,1875,2783,4658,2059179
2002-01,New York,705,6459,7164,19378102
2002-01,North Carolina,136,10471,10607,9535483
2002-01,North Dakota,342,1202,1544,672591
2002-01,Ohio,8196,11245,19441,11536504
2002-01,Oklahoma,3563,5878,9441,3751351
2002-01,Oregon,3777,5784,9561,3831074
2002-01,Pennsylvania,0,41439,41439,12702379
2002-01,Rhode Island,389,396,785,1052567
2002-01,South Carolina,3143,3893,7036,4625364
2002-01,South Dakota,563,1943,2506,814180
2002-01,Tennessee,8194,9245,17439,6346105
2002-01,Texas,12668,21157,33825,25145561
2002-01,Utah,1525,2982,4507,2763885
2002-01,Vermont,423,805,1228,625741
2002-01,Virginia,5668,8209,13877,8001024
2002-01,Washington,3261,4866,8127,6724540
2002-01,West Virginia,2499,4433,6932,1852994
2002-01,Wisconsin,3320,7652,10972,5686986
2002-01,Wyoming,641,1265,1906,563626
2001-12,Alabama,7104,23780,30884,4779736
2001-12,Arizona,6010,8997,15007,6392017
2001-12,Arkansas,3290,15215,18505,2915918
2001-12,California,25466,36862,62328,37253956
2001-12,Colorado,12818,26909,39727,5029196
2001-12,Connecticut,2306,3017,5323,3574097
2001-12,Delaware,524,1923,2447,897934
2001-12,District of Columbia,1,0,1,601723
2001-12,Florida,12438,21872,34310,18801310
2001-12,Georgia,8581,24059,32640,9687653
2001-12,Idaho,1383,4833,6216,1567582
2001-12,Illinois,5663,13033,18696,12830632
2001-12,Indiana,2190,10508,12698,6483802
2001-12,Iowa,42,6400,6442,3046355
2001-12,Kansas,2474,9226,11700,2853118
2001-12,Kentucky,8432,21097,29529,4339367
2001-12,Louisiana,4963,17836,22799,4533372
2001-12,Maine,1233,3473,4706,1328361
2001-12,Maryland,88,7035,7123,5773552
2001-12,Massachusetts,1588,1535,3123,6547629
2001-12,Michigan,1457,22559,24016,9883640
2001-12,Minnesota,2768,11330,14098,5303925
2001-12,Mississippi,3990,16220,20210,2967297
2001-12,Missouri,3407,21737,25144,5988927
2001-12,Montana,1465,4622,6087,989415
2001-12,Nebraska,38,4464,4502,1826341
2001-12,Nevada,2471,3432,5903,2700551
2001-12,New Hampshire,1436,2841,4277,1316470
2001-12,New Jersey,1430,3023,4453,8791894
2001-12,New Mexico,2297,5511,7808,2059179
2001-12,New York,661,13163,13824,19378102
2001-12,North Carolina,213,28207,28420,9535483
2001-12,North Dakota,437,2537,2974,672591
2001-12,Ohio,10429,25434,35863,11536504
2001-12,Oklahoma,4416,13942,18358,3751351
2001-12,Oregon,4357,11357,15714,3831074
2001-12,Pennsylvania,0,56382,56382,12702379
2001-12,Rhode Island,337,522,859,1052567
2001-12,South Carolina,4124,11884,16008,4625364
2001-12,South Dakota,704,3911,4615,814180
2001-12,Tennessee,10291,22295,32586,6346105
2001-12,Texas,16687,54247,70934,25145561
2001-12,Utah,2193,7486,9679,2763885
2001-12,Vermont,525,1505,2030,625741
2001-12,Virginia,7523,19450,26973,8001024
2001-12,Washington,3497,9109,12606,6724540
2001-12,West Virginia,3950,10884,14834,1852994
2001-12,Wisconsin,4130,13453,17583,5686986
2001-12,Wyoming,928,2573,3501,563626
2001-11,Alabama,5948,17304,23252,4779736
2001-11,Arizona,4984,6032,11016,6392017
2001-11,Arkansas,2765,14483,17248,2915918
2001-11,California,23365,30778,54143,37253956
2001-11,Colorado,11237,23148,34385,5029196
2001-11,Connecticut,2072,3298,5370,3574097
2001-11,Delaware,455,1685,2140,897934
2001-11,District of Columbia,1,1,2,601723
2001-11,Florida,12467,16929,29396,18801310
2001-11,Georgia,6273,16541,22814,9687653
2001-11,Idaho,1131,3681,4812,1567582
2001-11,Illinois,5174,11890,17064,12830632
2001-11,Indiana,2046,10756,12802,6483802
2001-11,Iowa,34,6560,6594,3046355
2001-11,Kansas,2046,9198,11244,2853118
2001-11,Kentucky,6437,17534,23971,4339367
2001-11,Louisiana,3681,14142,17823,4533372
2001-11,Maine,1109,3642,4751,1328361
2001-11,Maryland,62,7685,7747,5773552
2001-11,Massachusetts,1436,1742,3178,6547629
2001-11,Michigan,1040,26457,27497,9883640
2001-11,Minnesota,2213,9844,12057,5303925
2001-11,Mississippi,3146,14213,17359,2967297
2001-11,Missouri,2846,18256,21102,5988927
2001-11,Montana,1147,3604,4751,989415
2001-11,Nebraska,19,4104,4123,1826341
2001-11,Nevada,1876,2283,4159,2700551
2001-11,New Hampshire,1429,3039,4468,1316470
2001-11,New Jersey,1288,3491,4779,8791894
2001-11,New Mexico,2098,4111,6209,2059179
2001-11,New York,718,16313,17031,19378102
2001-11,North Carolina,204,20487,20691,9535483
2001-11,North Dakota,331,2666,2997,672591
2001-11,Ohio,9547,27085,36632,11536504
2001-11,Oklahoma,3321,10999,14320,3751351
2001-11,Oregon,4024,8016,12040,3831074
2001-11,Pennsylvania,0,62739,62739,12702379
2001-11,Rhode Island,423,565,988,1052567
2001-11,South Carolina,3362,8269,11631,4625364
2001-11,South Dakota,558,3714,4272,814180
2001-11,Tennessee,9085,17865,26950,6346105
2001-11,Texas,13772,36763,50535,25145561
2001-11,Utah,1817,4888,6705,2763885
2001-11,Vermont,552,1939,2491,625741
2001-11,Virginia,6548,16903,23451,8001024
2001-11,Washington,3403,6758,10161,6724540
2001-11,West Virginia,2942,12122,15064,1852994
2001-11,Wisconsin,3641,17449,21090,5686986
2001-11,Wyoming,646,1906,2552,563626
2001-10,Alabama,8053,14497,22550,4779736
2001-10,Arizona,6110,7309,13419,6392017
2001-10,Arkansas,3823,13548,17371,2915918
2001-10,California,29908,33462,63370,37253956
2001-10,Colorado,14916,27094,42010,5029196
2001-10,Connecticut,2995,4285,7280,3574097
2001-10,Delaware,642,1522,2164,897934
2001-10,District of Columbia,1,0,1,601723
2001-10,Florida,18244,18160,36404,18801310
2001-10,Georgia,8210,16323,24533,9687653
2001-10,Idaho,1516,5591,7107,1567582
2001-10,Illinois,6453,11358,17811,12830632
2001-10,Indiana,2816,8059,10875,6483802
2001-10,Iowa,51,5559,5610,3046355
2001-10,Kansas,2980,7909,10889,2853118
2001-10,Kentucky,7791,16514,24305,4339367
2001-10,Louisiana,5323,15923,21246,4533372
2001-10,Maine,1677,7545,9222,1328361
2001-10,Maryland,106,7044,7150,5773552
2001-10,Massachusetts,1864,1915,3779,6547629
2001-10,Michigan,1081,24102,25183,9883640
2001-10,Minnesota,3027,20613,23640,5303925
2001-10,Mississippi,4518,11473,15991,2967297
2001-10,Missouri,3898,20665,24563,5988927
2001-10,Montana,1651,7683,9334,989415
2001-10,Nebraska,33,4134,4167,1826341
2001-10,Nevada,2502,2592,5094,2700551
2001-10,New Hampshire,1889,3858,5747,1316470
2001-10,New Jersey,1276,3377,4653,8791894
2001-10,New Mexico,3113,5868,8981,2059179
2001-10,New York,862,17888,18750,19378102
2001-10,North Carolina,1229,20323,21552,9535483
2001-10,North Dakota,521,4252,4773,672591
2001-10,Ohio,11875,20973,32848,11536504
2001-10,Oklahoma,5535,11611,17146,3751351
2001-10,Oregon,4478,9177,13655,3831074
2001-10,Pennsylvania,0,62393,62393,12702379
2001-10,Rhode Island,631,759,1390,1052567
2001-10,South Carolina,4350,7930,12280,4625364
2001-10,South Dakota,750,5811,6561,814180
2001-10,Tennessee,10224,13530,23754,6346105
2001-10,Texas,19609,44744,64353,25145561
2001-10,Utah,1898,5324,7222,2763885
2001-10,Vermont,738,2302,3040,625741
2001-10,Virginia,8322,14465,22787,8001024
2001-10,Washington,4908,10897,15805,6724540
2001-10,West Virginia,3872,13387,17259,1852994
2001-10,Wisconsin,4952,20458,25410,5686986
2001-10,Wyoming,840,2260,3100,563626
2001-09,Alabama,7433,13656,21089,4779736
2001-09,Arizona,6203,6997,13200,6392017
2001-09,Arkansas,3310,11286,14596,2915918
2001-09,California,24601,32480,57081,37253956
2001-09,Colorado,13461,22466,35927,5029196
2001-09,Connecticut,2023,2546,4569,3574097
2001-09,Delaware,545,1198,1743,897934
2001-09,District of Columbia,1,0,1,601723
2001-09,Florida,13916,14350,28266,18801310
2001-09,Georgia,7420,12309,19729,9687653
2001-09,Idaho,1703,5850,7553,1567582
2001-09,Illinois,5336,8918,14254,12830632
2001-09,Indiana,2110,6525,8635,6483802
2001-09,Iowa,38,4548,4586,3046355
2001-09,Kansas,2325,5962,8287,2853118
2001-09,Kentucky,6601,13075,19676,4339367
2001-09,Louisiana,5396,12729,18125,4533372
2001-09,Maine,1497,5327,6824,1328361
2001-09,Maryland,124,5447,5571,5773552
2001-09,Massachusetts,1402,1405,2807,6547629
2001-09,Michigan,681,23900,24581,9883640
2001-09,Minnesota,2558,19908,22466,5303925
2001-09,Mississippi,4116,8652,12768,2967297
2001-09,Missouri,2873,14934,17807,5988927
2001-09,Montana,1783,6298,8081,989415
2001-09,Nebraska,23,3051,3074,1826341
2001-09,Nevada,2406,2745,5151,2700551
2001-09,New Hampshire,1698,3319,5017,1316470
2001-09,New Jersey,1008,2300,3308,8791894
2001-09,New Mexico,2518,5052,7570,2059179
2001-09,New York,657,14606,15263,19378102
2001-09,North Carolina,1328,16248,17576,9535483
2001-09,North Dakota,415,3601,4016,672591
2001-09,Ohio,10647,18571,29218,11536504
2001-09,Oklahoma,4246,9910,14156,3751351
2001-09,Oregon,4555,11686,16241,3831074
2001-09,Pennsylvania,0,48700,48700,12702379
2001-09,Rhode Island,488,581,1069,1052567
2001-09,South Carolina,3933,7308,11241,4625364
2001-09,South Dakota,661,4258,4919,814180
2001-09,Tennessee,7929,11245,19174,6346105
2001-09,Texas,18222,45986,64208,25145561
2001-09,Utah,1771,5265,7036,2763885
2001-09,Vermont,633,1842,2475,625741
2001-09,Virginia,6736,11037,17773,8001024
2001-09,Washington,3789,9918,13707,6724540
2001-09,West Virginia,3105,9195,12300,1852994
2001-09,Wisconsin,4000,17960,21960,5686986
2001-09,Wyoming,927,2850,3777,563626
2001-08,Alabama,6933,10464,17397,4779736
2001-08,Arizona,4599,5870,10469,6392017
2001-08,Arkansas,3042,9610,12652,2915918
2001-08,California,21708,29690,51398,37253956
2001-08,Colorado,10320,17920,28240,5029196
2001-08,Connecticut,6,3,9,3574097
2001-08,Delaware,333,763,1096,897934
2001-08,District of Columbia,0,0,0,601723
2001-08,Florida,10482,10390,20872,18801310
2001-08,Georgia,5655,10421,16076,9687653
2001-08,Idaho,1370,4101,5471,1567582
2001-08,Illinois,3958,7870,11828,12830632
2001-08,Indiana,1455,5191,6646,6483802
2001-08,Iowa,24,2567,2591,3046355
2001-08,Kansas,1857,5072,6929,2853118
2001-08,Kentucky,6483,12728,19211,4339367
2001-08,Louisiana,4846,10846,15692,4533372
2001-08,Maine,978,2961,3939,1328361
2001-08,Maryland,126,3427,3553,5773552
2001-08,Massachusetts,1060,913,1973,6547629
2001-08,Michigan,246,12875,13121,9883640
2001-08,Minnesota,2265,12237,14502,5303925
2001-08,Mississippi,4108,9531,13639,2967297
2001-08,Missouri,2577,12759,15336,5988927
2001-08,Montana,1585,4623,6208,989415
2001-08,Nebraska,24,2104,2128,1826341
2001-08,Nevada,1813,2010,3823,2700551
2001-08,New Hampshire,1060,1958,3018,1316470
2001-08,New Jersey,973,1642,2615,8791894
2001-08,New Mexico,2404,4467,6871,2059179
2001-08,New York,532,6766,7298,19378102
2001-08,North Carolina,1568,14892,16460,9535483
2001-08,North Dakota,314,2103,2417,672591
2001-08,Ohio,6825,13486,20311,11536504
2001-08,Oklahoma,4144,9095,13239,3751351
2001-08,Oregon,3372,7307,10679,3831074
2001-08,Pennsylvania,0,34538,34538,12702379
2001-08,Rhode Island,308,373,681,1052567
2001-08,South Carolina,3451,6898,10349,4625364
2001-08,South Dakota,497,2820,3317,814180
2001-08,Tennessee,7150,11294,18444,6346105
2001-08,Texas,13904,40941,54845,25145561
2001-08,Utah,1319,3514,4833,2763885
2001-08,Vermont,378,1023,1401,625741
2001-08,Virginia,4814,8793,13607,8001024
2001-08,Washington,3172,7174,10346,6724540
2001-08,West Virginia,2934,7052,9986,1852994
2001-08,Wisconsin,2706,10905,13611,5686986
2001-08,Wyoming,808,2000,2808,563626
2001-07,Alabama,5923,6829,12752,4779736
2001-07,Arizona,4315,4340,8655,6392017
2001-07,Arkansas,2598,5599,8197,2915918
2001-07,California,19849,24110,43959,37253956
2001-07,Colorado,8862,11989,20851,5029196
2001-07,Connecticut,0,0,0,3574097
2001-07,Delaware,290,510,800,897934
2001-07,District of Columbia,0,0,0,601723
2001-07,Florida,9609,7813,17422,18801310
2001-07,Georgia,4916,6099,11015,9687653
2001-07,Idaho,1197,2725,3922,1567582
2001-07,Illinois,3412,5155,8567,12830632
2001-07,Indiana,1309,3134,4443,6483802
2001-07,Iowa,29,1550,1579,3046355
2001-07,Kansas,1655,3073,4728,2853118
2001-07,Kentucky,5358,7408,12766,4339367
2001-07,Louisiana,4293,6035,10328,4533372
2001-07,Maine,813,2017,2830,1328361
2001-07,Maryland,99,2530,2629,5773552
2001-07,Massachusetts,962,699,1661,6547629
2001-07,Michigan,73,8164,8237,9883640
2001-07,Minnesota,1884,6480,8364,5303925
2001-07,Mississippi,3461,4985,8446,2967297
2001-07,Missouri,2345,7982,10327,5988927
2001-07,Montana,1314,3271,4585,989415
2001-07,Nebraska,18,1342,1360,1826341
2001-07,Nevada,1762,1629,3391,2700551
2001-07,New Hampshire,1047,1515,2562,1316470
2001-07,New Jersey,884,1214,2098,8791894
2001-07,New Mexico,2072,3149,5221,2059179
2001-07,New York,673,4818,5491,19378102
2001-07,North Carolina,1213,8778,9991,9535483
2001-07,North Dakota,280,1322,1602,672591
2001-07,Ohio,5506,8132,13638,11536504
2001-07,Oklahoma,3284,5722,9006,3751351
2001-07,Oregon,2973,5343,8316,3831074
2001-07,Pennsylvania,0,27941,27941,12702379
2001-07,Rhode Island,255,245,500,1052567
2001-07,South Carolina,2908,3678,6586,4625364
2001-07,South Dakota,446,1764,2210,814180
2001-07,Tennessee,6112,6363,12475,6346105
2001-07,Texas,13201,21668,34869,25145561
2001-07,Utah,1232,2292,3524,2763885
2001-07,Vermont,413,762,1175,625741
2001-07,Virginia,5016,6382,11398,8001024
2001-07,Washington,2781,5262,8043,6724540
2001-07,West Virginia,2362,5091,7453,1852994
2001-07,Wisconsin,2485,6350,8835,5686986
2001-07,Wyoming,644,1422,2066,563626
2001-06,Alabama,6395,6595,12990,4779736
2001-06,Arizona,4444,4392,8836,6392017
2001-06,Arkansas,2845,5171,8016,2915918
2001-06,California,21688,25006,46694,37253956
2001-06,Colorado,8865,12316,21181,5029196
2001-06,Connecticut,9,4,13,3574097
2001-06,Delaware,334,497,831,897934
2001-06,District of Columbia,0,2,2,601723
2001-06,Florida,10116,7662,17778,18801310
2001-06,Georgia,5429,5782,11211,9687653
2001-06,Idaho,1325,2791,4116,1567582
2001-06,Illinois,3774,4788,8562,12830632
2001-06,Indiana,1441,3128,4569,6483802
2001-06,Iowa,22,1603,1625,3046355
2001-06,Kansas,1870,2911,4781,2853118
2001-06,Kentucky,5822,7658,13480,4339367
2001-06,Louisiana,4559,5423,9982,4533372
2001-06,Maine,780,1599,2379,1328361
2001-06,Maryland,105,2842,2947,5773552
2001-06,Massachusetts,1033,702,1735,6547629
2001-06,Michigan,73,8664,8737,9883640
2001-06,Minnesota,1985,5601,7586,5303925
2001-06,Mississippi,3894,4764,8658,2967297
2001-06,Missouri,2470,8085,10555,5988927
2001-06,Montana,1394,3628,5022,989415
2001-06,Nebraska,11,1297,1308,1826341
2001-06,Nevada,1719,1736,3455,2700551
2001-06,New Hampshire,942,1416,2358,1316470
2001-06,New Jersey,974,1384,2358,8791894
2001-06,New Mexico,2210,3227,5437,2059179
2001-06,New York,717,4485,5202,19378102
2001-06,North Carolina,1379,9020,10399,9535483
2001-06,North Dakota,345,1298,1643,672591
2001-06,Ohio,6155,8787,14942,11536504
2001-06,Oklahoma,3399,5627,9026,3751351
2001-06,Oregon,3805,6363,10168,3831074
2001-06,Pennsylvania,0,28828,28828,12702379
2001-06,Rhode Island,273,242,515,1052567
2001-06,South Carolina,3067,3260,6327,4625364
2001-06,South Dakota,477,1639,2116,814180
2001-06,Tennessee,6582,5997,12579,6346105
2001-06,Texas,13372,20512,33884,25145561
2001-06,Utah,1351,2728,4079,2763885
2001-06,Vermont,391,648,1039,625741
2001-06,Virginia,4793,6263,11056,8001024
2001-06,Washington,2853,5618,8471,6724540
2001-06,West Virginia,2570,4916,7486,1852994
2001-06,Wisconsin,2318,6101,8419,5686986
2001-06,Wyoming,688,1346,2034,563626
2001-05,Alabama,5892,6002,11894,4779736
2001-05,Arizona,4654,4073,8727,6392017
2001-05,Arkansas,2777,5046,7823,2915918
2001-05,California,27523,28029,55552,37253956
2001-05,Colorado,8794,11573,20367,5029196
2001-05,Connecticut,0,0,0,3574097
2001-05,Delaware,395,511,906,897934
2001-05,District of Columbia,2,1,3,601723
2001-05,Florida,9864,7324,17188,18801310
2001-05,Georgia,5199,5370,10569,9687653
2001-05,Idaho,1395,2903,4298,1567582
2001-05,Illinois,3969,4792,8761,12830632
2001-05,Indiana,2077,2696,4773,6483802
2001-05,Iowa,35,1468,1503,3046355
2001-05,Kansas,1830,2900,4730,2853118
2001-05,Kentucky,5730,6876,12606,4339367
2001-05,Louisiana,4058,4492,8550,4533372
2001-05,Maine,891,1616,2507,1328361
2001-05,Maryland,124,2233,2357,5773552
2001-05,Massachusetts,1085,714,1799,6547629
2001-05,Michigan,96,8354,8450,9883640
2001-05,Minnesota,2058,5580,7638,5303925
2001-05,Mississippi,3662,4133,7795,2967297
2001-05,Missouri,2458,7746,10204,5988927
2001-05,Montana,1458,3593,5051,989415
2001-05,Nebraska,14,1180,1194,1826341
2001-05,Nevada,1814,1598,3412,2700551
2001-05,New Hampshire,971,1427,2398,1316470
2001-05,New Jersey,1132,1507,2639,8791894
2001-05,New Mexico,2181,3142,5323,2059179
2001-05,New York,811,5133,5944,19378102
2001-05,North Carolina,1211,7858,9069,9535483
2001-05,North Dakota,354,1257,1611,672591
2001-05,Ohio,6322,8331,14653,11536504
2001-05,Oklahoma,3507,5461,8968,3751351
2001-05,Oregon,3282,5542,8824,3831074
2001-05,Pennsylvania,0,30291,30291,12702379
2001-05,Rhode Island,274,252,526,1052567
2001-05,South Carolina,3151,2868,6019,4625364
2001-05,South Dakota,494,1504,1998,814180
2001-05,Tennessee,6585,5489,12074,6346105
2001-05,Texas,13458,19377,32835,25145561
2001-05,Utah,1246,2437,3683,2763885
2001-05,Vermont,342,677,1019,625741
2001-05,Virginia,5009,6157,11166,8001024
2001-05,Washington,2836,4955,7791,6724540
2001-05,West Virginia,2521,4742,7263,1852994
2001-05,Wisconsin,2599,6258,8857,5686986
2001-05,Wyoming,710,1367,2077,563626
2001-04,Alabama,6004,6346,12350,4779736
2001-04,Arizona,4957,4363,9320,6392017
2001-04,Arkansas,2898,5344,8242,2915918
2001-04,California,27625,29110,56735,37253956
2001-04,Colorado,9666,12713,22379,5029196
2001-04,Connecticut,0,0,0,3574097
2001-04,Delaware,343,580,923,897934
2001-04,District of Columbia,2,1,3,601723
2001-04,Florida,10081,7707,17788,18801310
2001-04,Georgia,5249,5641,10890,9687653
2001-04,Idaho,1277,3207,4484,1567582
2001-04,Illinois,4220,5783,10003,12830632
2001-04,Indiana,1592,3145,4737,6483802
2001-04,Iowa,28,2306,2334,3046355
2001-04,Kansas,1924,3443,5367,2853118
2001-04,Kentucky,5610,8366,13976,4339367
2001-04,Louisiana,3943,4333,8276,4533372
2001-04,Maine,1122,2075,3197,1328361
2001-04,Maryland,126,2779,2905,5773552
2001-04,Massachusetts,1121,900,2021,6547629
2001-04,Michigan,81,11129,11210,9883640
2001-04,Minnesota,2508,8764,11272,5303925
2001-04,Mississippi,3758,4471,8229,2967297
2001-04,Missouri,2548,10005,12553,5988927
2001-04,Montana,1548,4061,5609,989415
2001-04,Nebraska,19,1324,1343,1826341
2001-04,Nevada,1742,1552,3294,2700551
2001-04,New Hampshire,1146,2012,3158,1316470
2001-04,New Jersey,1151,1508,2659,8791894
2001-04,New Mexico,2172,3432,5604,2059179
2001-04,New York,788,6964,7752,19378102
2001-04,North Carolina,997,8616,9613,9535483
2001-04,North Dakota,430,1507,1937,672591
2001-04,Ohio,7319,10962,18281,11536504
2001-04,Oklahoma,3959,6440,10399,3751351
2001-04,Oregon,3772,6965,10737,3831074
2001-04,Pennsylvania,0,35652,35652,12702379
2001-04,Rhode Island,303,344,647,1052567
2001-04,South Carolina,3004,3112,6116,4625364
2001-04,South Dakota,524,1750,2274,814180
2001-04,Tennessee,6271,5923,12194,6346105
2001-04,Texas,12884,19527,32411,25145561
2001-04,Utah,1690,2865,4555,2763885
2001-04,Vermont,442,1154,1596,625741
2001-04,Virginia,4954,6897,11851,8001024
2001-04,Washington,2906,5617,8523,6724540
2001-04,West Virginia,2594,5645,8239,1852994
2001-04,Wisconsin,3308,10920,14228,5686986
2001-04,Wyoming,674,1461,2135,563626
2001-03,Alabama,8099,9614,17713,4779736
2001-03,Arizona,5829,5024,10853,6392017
2001-03,Arkansas,4147,8398,12545,2915918
2001-03,California,19950,23299,43249,37253956
2001-03,Colorado,12566,16014,28580,5029196
2001-03,Connecticut,2,0,2,3574097
2001-03,Delaware,495,723,1218,897934
2001-03,District of Columbia,3,0,3,601723
2001-03,Florida,11532,10239,21771,18801310
2001-03,Georgia,7509,9325,16834,9687653
2001-03,Idaho,1712,3673,5385,1567582
2001-03,Illinois,5549,7788,13337,12830632
2001-03,Indiana,2916,4536,7452,6483802
2001-03,Iowa,40,3204,3244,3046355
2001-03,Kansas,3088,4864,7952,2853118
2001-03,Kentucky,7957,11918,19875,4339367
2001-03,Louisiana,5952,6356,12308,4533372
2001-03,Maine,1192,2123,3315,1328361
2001-03,Maryland,139,3613,3752,5773552
2001-03,Massachusetts,1444,1148,2592,6547629
2001-03,Michigan,138,13609,13747,9883640
2001-03,Minnesota,3097,9640,12737,5303925
2001-03,Mississippi,5199,6866,12065,2967297
2001-03,Missouri,3602,12674,16276,5988927
2001-03,Montana,1852,4189,6041,989415
2001-03,Nebraska,37,1914,1951,1826341
2001-03,Nevada,2135,2060,4195,2700551
2001-03,New Hampshire,1231,1868,3099,1316470
2001-03,New Jersey,1359,1988,3347,8791894
2001-03,New Mexico,3034,4488,7522,2059179
2001-03,New York,784,7254,8038,19378102
2001-03,North Carolina,1285,12283,13568,9535483
2001-03,North Dakota,485,1626,2111,672591
2001-03,Ohio,10033,14088,24121,11536504
2001-03,Oklahoma,4698,7988,12686,3751351
2001-03,Oregon,4479,7546,12025,3831074
2001-03,Pennsylvania,0,44140,44140,12702379
2001-03,Rhode Island,383,317,700,1052567
2001-03,South Carolina,4274,4974,9248,4625364
2001-03,South Dakota,725,2303,3028,814180
2001-03,Tennessee,9914,10636,20550,6346105
2001-03,Texas,17463,25029,42492,25145561
2001-03,Utah,1703,3509,5212,2763885
2001-03,Vermont,543,1184,1727,625741
2001-03,Virginia,6864,8628,15492,8001024
2001-03,Washington,3655,6355,10010,6724540
2001-03,West Virginia,3791,7310,11101,1852994
2001-03,Wisconsin,4285,13691,17976,5686986
2001-03,Wyoming,872,1599,2471,563626
2001-02,Alabama,8560,9923,18483,4779736
2001-02,Arizona,5978,5276,11254,6392017
2001-02,Arkansas,4932,9072,14004,2915918
2001-02,California,16549,21133,37682,37253956
2001-02,Colorado,9704,13117,22821,5029196
2001-02,Connecticut,0,0,0,3574097
2001-02,Delaware,433,632,1065,897934
2001-02,District of Columbia,1,0,1,601723
2001-02,Florida,11178,9795,20973,18801310
2001-02,Georgia,8465,9546,18011,9687653
2001-02,Idaho,1585,3489,5074,1567582
2001-02,Illinois,5512,6991,12503,12830632
2001-02,Indiana,3024,4593,7617,6483802
2001-02,Iowa,23,2719,2742,3046355
2001-02,Kansas,2642,4583,7225,2853118
2001-02,Kentucky,8668,11800,20468,4339367
2001-02,Louisiana,6178,6507,12685,4533372
2001-02,Maine,879,1690,2569,1328361
2001-02,Maryland,112,3670,3782,5773552
2001-02,Massachusetts,1225,900,2125,6547629
2001-02,Michigan,145,11727,11872,9883640
2001-02,Minnesota,2260,6303,8563,5303925
2001-02,Mississippi,6188,7688,13876,2967297
2001-02,Missouri,3345,12460,15805,5988927
2001-02,Montana,1492,3456,4948,989415
2001-02,Nebraska,25,1659,1684,1826341
2001-02,Nevada,1923,1816,3739,2700551
2001-02,New Hampshire,1199,1490,2689,1316470
2001-02,New Jersey,1112,1750,2862,8791894
2001-02,New Mexico,2788,4575,7363,2059179
2001-02,New York,749,6536,7285,19378102
2001-02,North Carolina,1706,12905,14611,9535483
2001-02,North Dakota,398,1318,1716,672591
2001-02,Ohio,9438,12781,22219,11536504
2001-02,Oklahoma,5316,8934,14250,3751351
2001-02,Oregon,3786,6475,10261,3831074
2001-02,Pennsylvania,0,35432,35432,12702379
2001-02,Rhode Island,342,347,689,1052567
2001-02,South Carolina,5077,4972,10049,4625364
2001-02,South Dakota,565,1767,2332,814180
2001-02,Tennessee,9584,9726,19310,6346105
2001-02,Texas,18089,26287,44376,25145561
2001-02,Utah,1822,3663,5485,2763885
2001-02,Vermont,530,913,1443,625741
2001-02,Virginia,6856,8204,15060,8001024
2001-02,Washington,3447,5796,9243,6724540
2001-02,West Virginia,3556,7064,10620,1852994
2001-02,Wisconsin,3461,9842,13303,5686986
2001-02,Wyoming,834,1574,2408,563626
2001-01,Alabama,7541,9904,17445,4779736
2001-01,Arizona,5113,4802,9915,6392017
2001-01,Arkansas,3701,8153,11854,2915918
2001-01,California,21812,24292,46104,37253956
2001-01,Colorado,10068,12723,22791,5029196
2001-01,Connecticut,1,0,1,3574097
2001-01,Delaware,415,665,1080,897934
2001-01,District of Columbia,0,0,0,601723
2001-01,Florida,11227,10396,21623,18801310
2001-01,Georgia,7091,9129,16220,9687653
2001-01,Idaho,1425,2970,4395,1567582
2001-01,Illinois,4933,6521,11454,12830632
2001-01,Indiana,2231,4029,6260,6483802
2001-01,Iowa,45,2523,2568,3046355
2001-01,Kansas,2736,4853,7589,2853118
2001-01,Kentucky,7413,9993,17406,4339367
2001-01,Louisiana,4899,7023,11922,4533372
2001-01,Maine,931,1603,2534,1328361
2001-01,Maryland,144,3098,3242,5773552
2001-01,Massachusetts,1270,952,2222,6547629
2001-01,Michigan,102,9686,9788,9883640
2001-01,Minnesota,2259,5555,7814,5303925
2001-01,Mississippi,4573,6707,11280,2967297
2001-01,Missouri,3142,10880,14022,5988927
2001-01,Montana,1242,2996,4238,989415
2001-01,Nebraska,32,1779,1811,1826341
2001-01,Nevada,1872,1723,3595,2700551
2001-01,New Hampshire,1209,1580,2789,1316470
2001-01,New Jersey,1204,1948,3152,8791894
2001-01,New Mexico,2237,3893,6130,2059179
2001-01,New York,677,5845,6522,19378102
2001-01,North Carolina,1400,12563,13963,9535483
2001-01,North Dakota,399,1299,1698,672591
2001-01,Ohio,8170,11130,19300,11536504
2001-01,Oklahoma,4471,7983,12454,3751351
2001-01,Oregon,3737,5566,9303,3831074
2001-01,Pennsylvania,0,33380,33380,12702379
2001-01,Rhode Island,368,327,695,1052567
2001-01,South Carolina,4221,4694,8915,4625364
2001-01,South Dakota,541,1747,2288,814180
2001-01,Tennessee,8239,8992,17231,6346105
2001-01,Texas,16863,26684,43547,25145561
2001-01,Utah,1385,3202,4587,2763885
2001-01,Vermont,385,636,1021,625741
2001-01,Virginia,5903,7776,13679,8001024
2001-01,Washington,3222,5201,8423,6724540
2001-01,West Virginia,3077,5905,8982,1852994
2001-01,Wisconsin,3239,6800,10039,5686986
2001-01,Wyoming,754,1433,2187,563626
2000-12,Alabama,8303,25733,34036,4779736
2000-12,Arizona,6109,8666,14775,6392017
2000-12,Arkansas,3657,15822,19479,2915918
2000-12,California,53977,38075,92052,37253956
2000-12,Colorado,12467,24437,36904,5029196
2000-12,Connecticut,0,0,0,3574097
2000-12,Delaware,456,1726,2182,897934
2000-12,District of Columbia,0,0,0,601723
2000-12,Florida,11695,21628,33323,18801310
2000-12,Georgia,9180,25379,34559,9687653
2000-12,Idaho,1804,5516,7320,1567582
2000-12,Illinois,5030,11213,16243,12830632
2000-12,Indiana,2032,9682,11714,6483802
2000-12,Iowa,20,5984,6004,3046355
2000-12,Kansas,2809,9950,12759,2853118
2000-12,Kentucky,8761,20686,29447,4339367
2000-12,Louisiana,5416,19712,25128,4533372
2000-12,Maine,964,3304,4268,1328361
2000-12,Maryland,131,6071,6202,5773552
2000-12,Massachusetts,1185,1250,2435,6547629
2000-12,Michigan,86,20467,20553,9883640
2000-12,Minnesota,2319,9585,11904,5303925
2000-12,Mississippi,5137,18867,24004,2967297
2000-12,Missouri,3088,20402,23490,5988927
2000-12,Montana,1678,5120,6798,989415
2000-12,Nebraska,57,4554,4611,1826341
2000-12,Nevada,2265,3483,5748,2700551
2000-12,New Hampshire,1362,2569,3931,1316470
2000-12,New Jersey,1089,2619,3708,8791894
2000-12,New Mexico,2623,6511,9134,2059179
2000-12,New York,664,11546,12210,19378102
2000-12,North Carolina,1278,29093,30371,9535483
2000-12,North Dakota,408,2163,2571,672591
2000-12,Ohio,9536,22917,32453,11536504
2000-12,Oklahoma,4197,15070,19267,3751351
2000-12,Oregon,4645,10731,15376,3831074
2000-12,Pennsylvania,0,44640,44640,12702379
2000-12,Rhode Island,299,473,772,1052567
2000-12,South Carolina,4695,13014,17709,4625364
2000-12,South Dakota,670,3257,3927,814180
2000-12,Tennessee,10037,22944,32981,6346105
2000-12,Texas,18413,59403,77816,25145561
2000-12,Utah,2292,8250,10542,2763885
2000-12,Vermont,454,1258,1712,625741
2000-12,Virginia,7026,17109,24135,8001024
2000-12,Washington,3165,9305,12470,6724540
2000-12,West Virginia,3818,10397,14215,1852994
2000-12,Wisconsin,3256,12575,15831,5686986
2000-12,Wyoming,965,2751,3716,563626
2000-11,Alabama,6654,20239,26893,4779736
2000-11,Arizona,4547,5576,10123,6392017
2000-11,Arkansas,3170,18139,21309,2915918
2000-11,California,37564,28987,66551,37253956
2000-11,Colorado,9945,18937,28882,5029196
2000-11,Connecticut,0,0,0,3574097
2000-11,Delaware,398,1592,1990,897934
2000-11,District of Columbia,3,0,3,601723
2000-11,Florida,9857,15023,24880,18801310
2000-11,Georgia,6062,16739,22801,9687653
2000-11,Idaho,1399,4112,5511,1567582
2000-11,Illinois,4644,11453,16097,12830632
2000-11,Indiana,1816,10652,12468,6483802
2000-11,Iowa,45,7001,7046,3046355
2000-11,Kansas,2259,9748,12007,2853118
2000-11,Kentucky,6552,18609,25161,4339367
2000-11,Louisiana,4504,16619,21123,4533372
2000-11,Maine,918,3383,4301,1328361
2000-11,Maryland,138,7056,7194,5773552
2000-11,Massachusetts,1032,1396,2428,6547629
2000-11,Michigan,79,25886,25965,9883640
2000-11,Minnesota,1965,10357,12322,5303925
2000-11,Mississippi,4030,17350,21380,2967297
2000-11,Missouri,3102,19526,22628,5988927
2000-11,Montana,1100,3969,5069,989415
2000-11,Nebraska,29,4285,4314,1826341
2000-11,Nevada,1720,2024,3744,2700551
2000-11,New Hampshire,1249,2848,4097,1316470
2000-11,New Jersey,1150,2911,4061,8791894
2000-11,New Mexico,2051,5014,7065,2059179
2000-11,New York,746,14052,14798,19378102
2000-11,North Carolina,1318,22587,23905,9535483
2000-11,North Dakota,315,2393,2708,672591
2000-11,Ohio,8048,26300,34348,11536504
2000-11,Oklahoma,3461,13826,17287,3751351
2000-11,Oregon,4111,7054,11165,3831074
2000-11,Pennsylvania,0,53376,53376,12702379
2000-11,Rhode Island,369,502,871,1052567
2000-11,South Carolina,3895,9241,13136,4625364
2000-11,South Dakota,381,3311,3692,814180
2000-11,Tennessee,8161,18095,26256,6346105
2000-11,Texas,14616,44315,58931,25145561
2000-11,Utah,1311,4480,5791,2763885
2000-11,Vermont,394,1769,2163,625741
2000-11,Virginia,5577,15558,21135,8001024
2000-11,Washington,2785,6580,9365,6724540
2000-11,West Virginia,2715,13705,16420,1852994
2000-11,Wisconsin,3341,17298,20639,5686986
2000-11,Wyoming,610,1896,2506,563626
2000-10,Alabama,6200,13169,19369,4779736
2000-10,Arizona,4580,6294,10874,6392017
2000-10,Arkansas,3170,13381,16551,2915918
2000-10,California,26412,25647,52059,37253956
2000-10,Colorado,8974,20424,29398,5029196
2000-10,Connecticut,0,0,0,3574097
2000-10,Delaware,404,1196,1600,897934
2000-10,District of Columbia,0,0,0,601723
2000-10,Florida,9923,12411,22334,18801310
2000-10,Georgia,6004,15314,21318,9687653
2000-10,Idaho,1348,5409,6757,1567582
2000-10,Illinois,4577,9617,14194,12830632
2000-10,Indiana,1906,7059,8965,6483802
2000-10,Iowa,36,6225,6261,3046355
2000-10,Kansas,2409,7936,10345,2853118
2000-10,Kentucky,6572,14428,21000,4339367
2000-10,Louisiana,4266,14967,19233,4533372
2000-10,Maine,1072,6425,7497,1328361
2000-10,Maryland,163,5146,5309,5773552
2000-10,Massachusetts,1105,1390,2495,6547629
2000-10,Michigan,79,23225,23304,9883640
2000-10,Minnesota,2340,20310,22650,5303925
2000-10,Mississippi,3915,11218,15133,2967297
2000-10,Missouri,2745,18284,21029,5988927
2000-10,Montana,1415,7439,8854,989415
2000-10,Nebraska,29,4802,4831,1826341
2000-10,Nevada,1711,2186,3897,2700551
2000-10,New Hampshire,1199,3299,4498,1316470
2000-10,New Jersey,1082,2139,3221,8791894
2000-10,New Mexico,2388,5979,8367,2059179
2000-10,New York,880,13632,14512,19378102
2000-10,North Carolina,1381,17797,19178,9535483
2000-10,North Dakota,349,4210,4559,672591
2000-10,Ohio,7568,17066,24634,11536504
2000-10,Oklahoma,3846,10675,14521,3751351
2000-10,Oregon,3515,7718,11233,3831074
2000-10,Pennsylvania,0,47193,47193,12702379
2000-10,Rhode Island,328,471,799,1052567
2000-10,South Carolina,3246,7432,10678,4625364
2000-10,South Dakota,477,5680,6157,814180
2000-10,Tennessee,7582,12200,19782,6346105
2000-10,Texas,14514,40940,55454,25145561
2000-10,Utah,1175,5285,6460,2763885
2000-10,Vermont,503,2165,2668,625741
2000-10,Virginia,5391,11906,17297,8001024
2000-10,Washington,2887,9149,12036,6724540
2000-10,West Virginia,2624,10840,13464,1852994
2000-10,Wisconsin,3826,20900,24726,5686986
2000-10,Wyoming,647,2322,2969,563626
2000-09,Alabama,6534,13085,19619,4779736
2000-09,Arizona,4925,6147,11072,6392017
2000-09,Arkansas,3118,11807,14925,2915918
2000-09,California,22518,25220,47738,37253956
2000-09,Colorado,9586,18542,28128,5029196
2000-09,Connecticut,0,0,0,3574097
2000-09,Delaware,307,957,1264,897934
2000-09,District of Columbia,0,0,0,601723
2000-09,Florida,9485,10130,19615,18801310
2000-09,Georgia,6280,12368,18648,9687653
2000-09,Idaho,1618,6046,7664,1567582
2000-09,Illinois,4206,8321,12527,12830632
2000-09,Indiana,1635,5809,7444,6483802
2000-09,Iowa,44,4671,4715,3046355
2000-09,Kansas,2010,5824,7834,2853118
2000-09,Kentucky,6500,13208,19708,4339367
2000-09,Louisiana,4733,12818,17551,4533372
2000-09,Maine,1078,4665,5743,1328361
2000-09,Maryland,135,4575,4710,5773552
2000-09,Massachusetts,999,1054,2053,6547629
2000-09,Michigan,74,23416,23490,9883640
2000-09,Minnesota,2358,20774,23132,5303925
2000-09,Mississippi,4209,9669,13878,2967297
2000-09,Missouri,2441,13584,16025,5988927
2000-09,Montana,1509,6283,7792,989415
2000-09,Nebraska,24,2986,3010,1826341
2000-09,Nevada,1877,2326,4203,2700551
2000-09,New Hampshire,1219,2919,4138,1316470
2000-09,New Jersey,1102,1854,2956,8791894
2000-09,New Mexico,2269,4861,7130,2059179
2000-09,New York,775,11623,12398,19378102
2000-09,North Carolina,1404,15660,17064,9535483
2000-09,North Dakota,367,3651,4018,672591
2000-09,Ohio,7361,16241,23602,11536504
2000-09,Oklahoma,3712,9086,12798,3751351
2000-09,Oregon,4050,10969,15019,3831074
2000-09,Pennsylvania,0,40956,40956,12702379
2000-09,Rhode Island,308,371,679,1052567
2000-09,South Carolina,3438,7245,10683,4625364
2000-09,South Dakota,472,4191,4663,814180
2000-09,Tennessee,7237,11546,18783,6346105
2000-09,Texas,14335,43313,57648,25145561
2000-09,Utah,1395,5562,6957,2763885
2000-09,Vermont,459,1754,2213,625741
2000-09,Virginia,5562,10679,16241,8001024
2000-09,Washington,2777,8836,11613,6724540
2000-09,West Virginia,2941,8915,11856,1852994
2000-09,Wisconsin,3349,18870,22219,5686986
2000-09,Wyoming,757,2829,3586,563626
2000-08,Alabama,6497,9632,16129,4779736
2000-08,Arizona,4891,5814,10705,6392017
2000-08,Arkansas,3389,8628,12017,2915918
2000-08,California,23875,26926,50801,37253956
2000-08,Colorado,9672,15215,24887,5029196
2000-08,Connecticut,0,0,0,3574097
2000-08,Delaware,322,708,1030,897934
2000-08,District of Columbia,1,0,1,601723
2000-08,Florida,10226,8969,19195,18801310
2000-08,Georgia,6128,9790,15918,9687653
2000-08,Idaho,1584,3865,5449,1567582
2000-08,Illinois,4340,7723,12063,12830632
2000-08,Indiana,1771,5006,6777,6483802
2000-08,Iowa,40,2850,2890,3046355
2000-08,Kansas,1954,4701,6655,2853118
2000-08,Kentucky,6486,11171,17657,4339367
2000-08,Louisiana,4525,9029,13554,4533372
2000-08,Maine,986,2613,3599,1328361
2000-08,Maryland,155,3376,3531,5773552
2000-08,Massachusetts,1151,831,1982,6547629
2000-08,Michigan,75,12962,13037,9883640
2000-08,Minnesota,2354,11873,14227,5303925
2000-08,Mississippi,4325,8527,12852,2967297
2000-08,Missouri,2557,11254,13811,5988927
2000-08,Montana,1437,4021,5458,989415
2000-08,Nebraska,18,2075,2093,1826341
2000-08,Nevada,1756,1877,3633,2700551
2000-08,New Hampshire,1248,1950,3198,1316470
2000-08,New Jersey,1229,1778,3007,8791894
2000-08,New Mexico,2361,4207,6568,2059179
2000-08,New York,661,7313,7974,19378102
2000-08,North Carolina,1388,14075,15463,9535483
2000-08,North Dakota,357,2366,2723,672591
2000-08,Ohio,7206,13268,20474,11536504
2000-08,Oklahoma,3720,7646,11366,3751351
2000-08,Oregon,3685,6407,10092,3831074
2000-08,Pennsylvania,0,33938,33938,12702379
2000-08,Rhode Island,298,326,624,1052567
2000-08,South Carolina,3859,6844,10703,4625364
2000-08,South Dakota,427,2736,3163,814180
2000-08,Tennessee,7836,11326,19162,6346105
2000-08,Texas,14220,36746,50966,25145561
2000-08,Utah,1470,3580,5050,2763885
2000-08,Vermont,436,1102,1538,625741
2000-08,Virginia,5296,8535,13831,8001024
2000-08,Washington,2651,6420,9071,6724540
2000-08,West Virginia,2668,6233,8901,1852994
2000-08,Wisconsin,3186,10819,14005,5686986
2000-08,Wyoming,726,1757,2483,563626
2000-07,Alabama,5508,6730,12238,4779736
2000-07,Arizona,4915,4399,9314,6392017
2000-07,Arkansas,2986,5554,8540,2915918
2000-07,California,22150,22700,44850,37253956
2000-07,Colorado,8018,10667,18685,5029196
2000-07,Connecticut,0,0,0,3574097
2000-07,Delaware,355,548,903,897934
2000-07,District of Columbia,1,0,1,601723
2000-07,Florida,9286,7175,16461,18801310
2000-07,Georgia,5855,6422,12277,9687653
2000-07,Idaho,1534,2753,4287,1567582
2000-07,Illinois,4157,5051,9208,12830632
2000-07,Indiana,1426,3076,4502,6483802
2000-07,Iowa,25,1688,1713,3046355
2000-07,Kansas,1851,3200,5051,2853118
2000-07,Kentucky,5823,7245,13068,4339367
2000-07,Louisiana,4310,5716,10026,4533372
2000-07,Maine,829,1814,2643,1328361
2000-07,Maryland,137,2766,2903,5773552
2000-07,Massachusetts,877,602,1479,6547629
2000-07,Michigan,70,9656,9726,9883640
2000-07,Minnesota,2168,6569,8737,5303925
2000-07,Mississippi,4092,5044,9136,2967297
2000-07,Missouri,2390,8117,10507,5988927
2000-07,Montana,1332,3228,4560,989415
2000-07,Nebraska,20,1457,1477,1826341
2000-07,Nevada,1842,1648,3490,2700551
2000-07,New Hampshire,1116,1597,2713,1316470
2000-07,New Jersey,1195,1327,2522,8791894
2000-07,New Mexico,2048,3229,5277,2059179
2000-07,New York,637,5026,5663,19378102
2000-07,North Carolina,1246,8984,10230,9535483
2000-07,North Dakota,326,1377,1703,672591
2000-07,Ohio,5923,8588,14511,11536504
2000-07,Oklahoma,3613,5620,9233,3751351
2000-07,Oregon,3136,4864,8000,3831074
2000-07,Pennsylvania,0,30329,30329,12702379
2000-07,Rhode Island,282,239,521,1052567
2000-07,South Carolina,3201,3742,6943,4625364
2000-07,South Dakota,375,1703,2078,814180
2000-07,Tennessee,8199,7695,15894,6346105
2000-07,Texas,14041,21850,35891,25145561
2000-07,Utah,1382,2512,3894,2763885
2000-07,Vermont,417,774,1191,625741
2000-07,Virginia,5268,6498,11766,8001024
2000-07,Washington,2594,5035,7629,6724540
2000-07,West Virginia,2638,4957,7595,1852994
2000-07,Wisconsin,2565,6924,9489,5686986
2000-07,Wyoming,656,1262,1918,563626
2000-06,Alabama,6144,6568,12712,4779736
2000-06,Arizona,5117,4170,9287,6392017
2000-06,Arkansas,3448,5543,8991,2915918
2000-06,California,22813,21337,44150,37253956
2000-06,Colorado,8931,10977,19908,5029196
2000-06,Connecticut,0,0,0,3574097
2000-06,Delaware,384,489,873,897934
2000-06,District of Columbia,0,0,0,601723
2000-06,Florida,10041,7298,17339,18801310
2000-06,Georgia,6209,5787,11996,9687653
2000-06,Idaho,1593,2725,4318,1567582
2000-06,Illinois,4241,4631,8872,12830632
2000-06,Indiana,1524,3051,4575,6483802
2000-06,Iowa,29,1633,1662,3046355
2000-06,Kansas,2057,3009,5066,2853118
2000-06,Kentucky,6376,7163,13539,4339367
2000-06,Louisiana,4562,4891,9453,4533372
2000-06,Maine,843,1519,2362,1328361
2000-06,Maryland,141,2495,2636,5773552
2000-06,Massachusetts,1057,590,1647,6547629
2000-06,Michigan,80,8801,8881,9883640
2000-06,Minnesota,2368,5976,8344,5303925
2000-06,Mississippi,4334,4721,9055,2967297
2000-06,Missouri,2881,8094,10975,5988927
2000-06,Montana,1554,3681,5235,989415
2000-06,Nebraska,24,1265,1289,1826341
2000-06,Nevada,1796,1702,3498,2700551
2000-06,New Hampshire,1194,1447,2641,1316470
2000-06,New Jersey,1414,1464,2878,8791894
2000-06,New Mexico,2389,3538,5927,2059179
2000-06,New York,707,4674,5381,19378102
2000-06,North Carolina,1400,8650,10050,9535483
2000-06,North Dakota,327,1385,1712,672591
2000-06,Ohio,6704,8657,15361,11536504
2000-06,Oklahoma,4044,6054,10098,3751351
2000-06,Oregon,3781,5410,9191,3831074
2000-06,Pennsylvania,7,30338,30345,12702379
2000-06,Rhode Island,355,273,628,1052567
2000-06,South Carolina,3557,3342,6899,4625364
2000-06,South Dakota,417,1457,1874,814180
2000-06,Tennessee,6777,5604,12381,6346105
2000-06,Texas,14721,20585,35306,25145561
2000-06,Utah,1487,2433,3920,2763885
2000-06,Vermont,435,690,1125,625741
2000-06,Virginia,5088,5883,10971,8001024
2000-06,Washington,2539,5128,7667,6724540
2000-06,West Virginia,2802,4452,7254,1852994
2000-06,Wisconsin,2772,6379,9151,5686986
2000-06,Wyoming,767,1325,2092,563626
2000-05,Alabama,5681,5940,11621,4779736
2000-05,Arizona,5115,4040,9155,6392017
2000-05,Arkansas,3314,5383,8697,2915918
2000-05,California,23637,21526,45163,37253956
2000-05,Colorado,7646,9195,16841,5029196
2000-05,Connecticut,0,0,0,3574097
2000-05,Delaware,398,458,856,897934
2000-05,District of Columbia,2,0,2,601723
2000-05,Florida,9593,6685,16278,18801310
2000-05,Georgia,5843,4990,10833,9687653
2000-05,Idaho,1563,2908,4471,1567582
2000-05,Illinois,4626,5124,9750,12830632
2000-05,Indiana,1763,2698,4461,6483802
2000-05,Iowa,29,1511,1540,3046355
2000-05,Kansas,2182,3157,5339,2853118
2000-05,Kentucky,5982,6622,12604,4339367
2000-05,Louisiana,4323,4558,8881,4533372
2000-05,Maine,922,1466,2388,1328361
2000-05,Maryland,143,2300,2443,5773552
2000-05,Massachusetts,948,614,1562,6547629
2000-05,Michigan,73,8599,8672,9883640
2000-05,Minnesota,2243,5585,7828,5303925
2000-05,Mississippi,4141,4206,8347,2967297
2000-05,Missouri,2675,7818,10493,5988927
2000-05,Montana,1586,3536,5122,989415
2000-05,Nebraska,26,1229,1255,1826341
2000-05,Nevada,2006,1676,3682,2700551
2000-05,New Hampshire,1002,1444,2446,1316470
2000-05,New Jersey,1246,1452,2698,8791894
2000-05,New Mexico,2405,3227,5632,2059179
2000-05,New York,737,5148,5885,19378102
2000-05,North Carolina,1203,7626,8829,9535483
2000-05,North Dakota,406,1243,1649,672591
2000-05,Ohio,6753,8260,15013,11536504
2000-05,Oklahoma,3634,5445,9079,3751351
2000-05,Oregon,3827,5258,9085,3831074
2000-05,Pennsylvania,2,30655,30657,12702379
2000-05,Rhode Island,333,256,589,1052567
2000-05,South Carolina,3332,2901,6233,4625364
2000-05,South Dakota,431,1455,1886,814180
2000-05,Tennessee,7082,5646,12728,6346105
2000-05,Texas,14332,19248,33580,25145561
2000-05,Utah,1530,2425,3955,2763885
2000-05,Vermont,475,733,1208,625741
2000-05,Virginia,5497,5727,11224,8001024
2000-05,Washington,2661,4836,7497,6724540
2000-05,West Virginia,2632,4378,7010,1852994
2000-05,Wisconsin,3070,6845,9915,5686986
2000-05,Wyoming,743,1285,2028,563626
2000-04,Alabama,6429,6406,12835,4779736
2000-04,Arizona,5884,4542,10426,6392017
2000-04,Arkansas,3647,6410,10057,2915918
2000-04,California,24372,22963,47335,37253956
2000-04,Colorado,9910,10726,20636,5029196
2000-04,Connecticut,5,1,6,3574097
2000-04,Delaware,465,632,1097,897934
2000-04,District of Columbia,3,0,3,601723
2000-04,Florida,10156,7068,17224,18801310
2000-04,Georgia,6666,6015,12681,9687653
2000-04,Idaho,1688,3332,5020,1567582
2000-04,Illinois,5361,5945,11306,12830632
2000-04,Indiana,1821,7664,9485,6483802
2000-04,Iowa,34,2250,2284,3046355
2000-04,Kansas,2206,3563,5769,2853118
2000-04,Kentucky,6728,9352,16080,4339367
2000-04,Louisiana,4918,4695,9613,4533372
2000-04,Maine,1014,1896,2910,1328361
2000-04,Maryland,105,3141,3246,5773552
2000-04,Massachusetts,1617,834,2451,6547629
2000-04,Michigan,104,11320,11424,9883640
2000-04,Minnesota,2930,8899,11829,5303925
2000-04,Mississippi,4375,4628,9003,2967297
2000-04,Missouri,3194,10893,14087,5988927
2000-04,Montana,1761,3872,5633,989415
2000-04,Nebraska,34,1392,1426,1826341
2000-04,Nevada,2040,1817,3857,2700551
2000-04,New Hampshire,1135,1922,3057,1316470
2000-04,New Jersey,1559,1396,2955,8791894
2000-04,New Mexico,2302,3797,6099,2059179
2000-04,New York,850,7639,8489,19378102
2000-04,North Carolina,1154,9381,10535,9535483
2000-04,North Dakota,539,1652,2191,672591
2000-04,Ohio,9283,11404,20687,11536504
2000-04,Oklahoma,4588,6688,11276,3751351
2000-04,Oregon,4327,6503,10830,3831074
2000-04,Pennsylvania,0,37781,37781,12702379
2000-04,Rhode Island,392,303,695,1052567
2000-04,South Carolina,3514,3478,6992,4625364
2000-04,South Dakota,536,1747,2283,814180
2000-04,Tennessee,7564,6545,14109,6346105
2000-04,Texas,14985,20674,35659,25145561
2000-04,Utah,1655,2672,4327,2763885
2000-04,Vermont,580,1116,1696,625741
2000-04,Virginia,6182,7052,13234,8001024
2000-04,Washington,2849,5406,8255,6724540
2000-04,West Virginia,3002,6087,9089,1852994
2000-04,Wisconsin,3704,10727,14431,5686986
2000-04,Wyoming,790,1531,2321,563626
2000-03,Alabama,7781,8947,16728,4779736
2000-03,Arizona,6811,5164,11975,6392017
2000-03,Arkansas,4607,8261,12868,2915918
2000-03,California,25411,24145,49556,37253956
2000-03,Colorado,12054,14284,26338,5029196
2000-03,Connecticut,0,0,0,3574097
2000-03,Delaware,543,694,1237,897934
2000-03,District of Columbia,2,0,2,601723
2000-03,Florida,11262,8575,19837,18801310
2000-03,Georgia,8428,8768,17196,9687653
2000-03,Idaho,1843,3617,5460,1567582
2000-03,Illinois,6602,7597,14199,12830632
2000-03,Indiana,2606,12476,15082,6483802
2000-03,Iowa,50,2844,2894,3046355
2000-03,Kansas,3464,4741,8205,2853118
2000-03,Kentucky,8289,10669,18958,4339367
2000-03,Louisiana,6149,5977,12126,4533372
2000-03,Maine,1410,2061,3471,1328361
2000-03,Maryland,152,3351,3503,5773552
2000-03,Massachusetts,1658,860,2518,6547629
2000-03,Michigan,89,12135,12224,9883640
2000-03,Minnesota,3710,9318,13028,5303925
2000-03,Mississippi,5636,6530,12166,2967297
2000-03,Missouri,4085,12164,16249,5988927
2000-03,Montana,1938,3932,5870,989415
2000-03,Nebraska,39,1676,1715,1826341
2000-03,Nevada,2287,1991,4278,2700551
2000-03,New Hampshire,1464,1848,3312,1316470
2000-03,New Jersey,1684,1508,3192,8791894
2000-03,New Mexico,3174,4399,7573,2059179
2000-03,New York,1316,7591,8907,19378102
2000-03,North Carolina,1412,11467,12879,9535483
2000-03,North Dakota,647,1762,2409,672591
2000-03,Ohio,11022,13025,24047,11536504
2000-03,Oklahoma,4864,7578,12442,3751351
2000-03,Oregon,5386,6908,12294,3831074
2000-03,Pennsylvania,0,47342,47342,12702379
2000-03,Rhode Island,464,352,816,1052567
2000-03,South Carolina,4768,5170,9938,4625364
2000-03,South Dakota,603,1881,2484,814180
2000-03,Tennessee,10389,9252,19641,6346105
2000-03,Texas,19236,25024,44260,25145561
2000-03,Utah,2099,3376,5475,2763885
2000-03,Vermont,702,1242,1944,625741
2000-03,Virginia,8120,9611,17731,8001024
2000-03,Washington,3630,6327,9957,6724540
2000-03,West Virginia,4101,6567,10668,1852994
2000-03,Wisconsin,4480,12120,16600,5686986
2000-03,Wyoming,965,1665,2630,563626
2000-02,Alabama,8710,10309,19019,4779736
2000-02,Arizona,6612,5254,11866,6392017
2000-02,Arkansas,5268,10046,15314,2915918
2000-02,California,23175,22390,45565,37253956
2000-02,Colorado,10847,12928,23775,5029196
2000-02,Connecticut,0,0,0,3574097
2000-02,Delaware,487,644,1131,897934
2000-02,District of Columbia,1,0,1,601723
2000-02,Florida,11071,9088,20159,18801310
2000-02,Georgia,9255,9820,19075,9687653
2000-02,Idaho,1818,3373,5191,1567582
2000-02,Illinois,6515,7141,13656,12830632
2000-02,Indiana,2452,12274,14726,6483802
2000-02,Iowa,46,2776,2822,3046355
2000-02,Kansas,3182,4811,7993,2853118
2000-02,Kentucky,9215,11955,21170,4339367
2000-02,Louisiana,6288,6746,13034,4533372
2000-02,Maine,1057,1614,2671,1328361
2000-02,Maryland,167,3358,3525,5773552
2000-02,Massachusetts,1394,730,2124,6547629
2000-02,Michigan,85,11080,11165,9883640
2000-02,Minnesota,2743,6831,9574,5303925
2000-02,Mississippi,6988,7932,14920,2967297
2000-02,Missouri,4077,12722,16799,5988927
2000-02,Montana,1699,3477,5176,989415
2000-02,Nebraska,52,1678,1730,1826341
2000-02,Nevada,2297,1988,4285,2700551
2000-02,New Hampshire,1173,1474,2647,1316470
2000-02,New Jersey,1366,1366,2732,8791894
2000-02,New Mexico,2964,4520,7484,2059179
2000-02,New York,960,6116,7076,19378102
2000-02,North Carolina,1747,13279,15026,9535483
2000-02,North Dakota,497,1380,1877,672591
2000-02,Ohio,10979,12697,23676,11536504
2000-02,Oklahoma,5465,9111,14576,3751351
2000-02,Oregon,4920,6442,11362,3831074
2000-02,Pennsylvania,0,36991,36991,12702379
2000-02,Rhode Island,442,317,759,1052567
2000-02,South Carolina,5389,5524,10913,4625364
2000-02,South Dakota,531,1728,2259,814180
2000-02,Tennessee,10708,10149,20857,6346105
2000-02,Texas,19266,27237,46503,25145561
2000-02,Utah,2357,3406,5763,2763885
2000-02,Vermont,579,981,1560,625741
2000-02,Virginia,6927,8623,15550,8001024
2000-02,Washington,3163,5791,8954,6724540
2000-02,West Virginia,3957,7330,11287,1852994
2000-02,Wisconsin,3830,9172,13002,5686986
2000-02,Wyoming,906,1729,2635,563626
2000-01,Alabama,7542,10009,17551,4779736
2000-01,Arizona,5761,4762,10523,6392017
2000-01,Arkansas,3684,7911,11595,2915918
2000-01,California,22711,22830,45541,37253956
2000-01,Colorado,9950,12557,22507,5029196
2000-01,Connecticut,3,3,6,3574097
2000-01,Delaware,429,616,1045,897934
2000-01,District of Columbia,4,0,4,601723
2000-01,Florida,9967,8871,18838,18801310
2000-01,Georgia,7828,8832,16660,9687653
2000-01,Idaho,1493,2740,4233,1567582
2000-01,Illinois,6205,7059,13264,12830632
2000-01,Indiana,2230,12428,14658,6483802
2000-01,Iowa,42,2563,2605,3046355
2000-01,Kansas,2994,4852,7846,2853118
2000-01,Kentucky,7404,9685,17089,4339367
2000-01,Louisiana,5333,7232,12565,4533372
2000-01,Maine,962,1602,2564,1328361
2000-01,Maryland,141,2896,3037,5773552
2000-01,Massachusetts,1044,706,1750,6547629
2000-01,Michigan,70,10116,10186,9883640
2000-01,Minnesota,2486,5074,7560,5303925
2000-01,Mississippi,4960,7057,12017,2967297
2000-01,Missouri,3288,10698,13986,5988927
2000-01,Montana,1392,2922,4314,989415
2000-01,Nebraska,41,1722,1763,1826341
2000-01,Nevada,2220,1887,4107,2700551
2000-01,New Hampshire,1134,1581,2715,1316470
2000-01,New Jersey,1147,1419,2566,8791894
2000-01,New Mexico,2408,3766,6174,2059179
2000-01,New York,691,5567,6258,19378102
2000-01,North Carolina,1296,11405,12701,9535483
2000-01,North Dakota,456,1232,1688,672591
2000-01,Ohio,8932,10795,19727,11536504
2000-01,Oklahoma,4388,7340,11728,3751351
2000-01,Oregon,4251,5248,9499,3831074
2000-01,Pennsylvania,1,33945,33946,12702379
2000-01,Rhode Island,346,338,684,1052567
2000-01,South Carolina,4275,4964,9239,4625364
2000-01,South Dakota,448,1527,1975,814180
2000-01,Tennessee,9426,9238,18664,6346105
2000-01,Texas,16975,25892,42867,25145561
2000-01,Utah,1788,2782,4570,2763885
2000-01,Vermont,433,679,1112,625741
2000-01,Virginia,6044,7453,13497,8001024
2000-01,Washington,2794,4919,7713,6724540
2000-01,West Virginia,3059,5374,8433,1852994
2000-01,Wisconsin,3425,6937,10362,5686986
2000-01,Wyoming,776,1385,2161,563626
1999-12,Alabama,10923,29890,40813,4779736
1999-12,Arizona,9128,10665,19793,6392017
1999-12,Arkansas,5482,19908,25390,2915918
1999-12,California,49418,77697,127115,37253956
1999-12,Colorado,16919,27112,44031,5029196
1999-12,Connecticut,1944,2367,4311,3574097
1999-12,Delaware,795,2146,2941,897934
1999-12,District of Columbia,2,0,2,601723
1999-12,Florida,14736,24200,38936,18801310
1999-12,Georgia,16017,27898,43915,9687653
1999-12,Idaho,2456,5936,8392,1567582
1999-12,Illinois,9292,15448,24740,12830632
1999-12,Indiana,4311,20476,24787,6483802
1999-12,Iowa,50,7721,7771,3046355
1999-12,Kansas,3700,11091,14791,2853118
1999-12,Kentucky,11426,23480,34906,4339367
1999-12,Louisiana,7460,22840,30300,4533372
1999-12,Maine,1320,3561,4881,1328361
1999-12,Maryland,209,8127,8336,5773552
1999-12,Massachusetts,1377,1358,2735,6547629
1999-12,Michigan,112,26295,26407,9883640
1999-12,Minnesota,3613,12175,15788,5303925
1999-12,Mississippi,7253,21383,28636,2967297
1999-12,Missouri,4792,23830,28622,5988927
1999-12,Montana,1976,5158,7134,989415
1999-12,Nebraska,54,5388,5442,1826341
1999-12,Nevada,3593,4569,8162,2700551
1999-12,New Hampshire,1680,3083,4763,1316470
1999-12,New Jersey,1468,3129,4597,8791894
1999-12,New Mexico,3919,7953,11872,2059179
1999-12,New York,778,14673,15451,19378102
1999-12,North Carolina,1725,33628,35353,9535483
1999-12,North Dakota,549,2648,3197,672591
1999-12,Ohio,14076,26744,40820,11536504
1999-12,Oklahoma,6746,17121,23867,3751351
1999-12,Oregon,7507,13070,20577,3831074
1999-12,Pennsylvania,1,56133,56134,12702379
1999-12,Rhode Island,482,620,1102,1052567
1999-12,South Carolina,6716,14799,21515,4625364
1999-12,South Dakota,575,3367,3942,814180
1999-12,Tennessee,14717,26478,41195,6346105
1999-12,Texas,26652,69368,96020,25145561
1999-12,Utah,3400,8661,12061,2763885
1999-12,Vermont,678,1726,2404,625741
1999-12,Virginia,10238,19346,29584,8001024
1999-12,Washington,3847,12408,16255,6724540
1999-12,West Virginia,4618,11087,15705,1852994
1999-12,Wisconsin,4753,14191,18944,5686986
1999-12,Wyoming,1165,2914,4079,563626
1999-11,Alabama,7677,21455,29132,4779736
1999-11,Arizona,5709,6185,11894,6392017
1999-11,Arkansas,3877,19531,23408,2915918
1999-11,California,33398,46599,79997,37253956
1999-11,Colorado,11344,18611,29955,5029196
1999-11,Connecticut,1807,2583,4390,3574097
1999-11,Delaware,625,1760,2385,897934
1999-11,District of Columbia,0,0,0,601723
1999-11,Florida,10440,15319,25759,18801310
1999-11,Georgia,7789,17248,25037,9687653
1999-11,Idaho,1743,4225,5968,1567582
1999-11,Illinois,6572,13699,20271,12830632
1999-11,Indiana,2557,19673,22230,6483802
1999-11,Iowa,41,7507,7548,3046355
1999-11,Kansas,2973,10615,13588,2853118
1999-11,Kentucky,8000,19835,27835,4339367
1999-11,Louisiana,5336,18423,23759,4533372
1999-11,Maine,990,3709,4699,1328361
1999-11,Maryland,180,7935,8115,5773552
1999-11,Massachusetts,1154,1366,2520,6547629
1999-11,Michigan,111,28946,29057,9883640
1999-11,Minnesota,2426,12272,14698,5303925
1999-11,Mississippi,5005,18516,23521,2967297
1999-11,Missouri,3255,20974,24229,5988927
1999-11,Montana,1304,4376,5680,989415
1999-11,Nebraska,56,4578,4634,1826341
1999-11,Nevada,2542,2672,5214,2700551
1999-11,New Hampshire,1311,2963,4274,1316470
1999-11,New Jersey,1318,3086,4404,8791894
1999-11,New Mexico,2534,5441,7975,2059179
1999-11,New York,728,15637,16365,19378102
1999-11,North Carolina,1494,24469,25963,9535483
1999-11,North Dakota,394,2444,2838,672591
1999-11,Ohio,10639,27755,38394,11536504
1999-11,Oklahoma,4305,14383,18688,3751351
1999-11,Oregon,5229,12708,17937,3831074
1999-11,Pennsylvania,4082,58877,62959,12702379
1999-11,Rhode Island,425,543,968,1052567
1999-11,South Carolina,4494,9898,14392,4625364
1999-11,South Dakota,366,3318,3684,814180
1999-11,Tennessee,9922,18181,28103,6346105
1999-11,Texas,18069,46989,65058,25145561
1999-11,Utah,2094,5449,7543,2763885
1999-11,Vermont,453,1969,2422,625741
1999-11,Virginia,6762,16104,22866,8001024
1999-11,Washington,2736,7904,10640,6724540
1999-11,West Virginia,3184,14108,17292,1852994
1999-11,Wisconsin,3654,19030,22684,5686986
1999-11,Wyoming,775,2000,2775,563626
1999-10,Alabama,7625,14581,22206,4779736
1999-10,Arizona,6182,6954,13136,6392017
1999-10,Arkansas,4120,14545,18665,2915918
1999-10,California,32530,37421,69951,37253956
1999-10,Colorado,11307,20319,31626,5029196
1999-10,Connecticut,2191,2578,4769,3574097
1999-10,Delaware,586,1318,1904,897934
1999-10,District of Columbia,5,0,5,601723
1999-10,Florida,10448,12058,22506,18801310
1999-10,Georgia,8189,17391,25580,9687653
1999-10,Idaho,1729,6182,7911,1567582
1999-10,Illinois,5854,10776,16630,12830632
1999-10,Indiana,2457,16865,19322,6483802
1999-10,Iowa,48,6840,6888,3046355
1999-10,Kansas,3318,8025,11343,2853118
1999-10,Kentucky,7824,15817,23641,4339367
1999-10,Louisiana,5516,16218,21734,4533372
1999-10,Maine,1267,7150,8417,1328361
1999-10,Maryland,186,5743,5929,5773552
1999-10,Massachusetts,1223,1254,2477,6547629
1999-10,Michigan,99,24306,24405,9883640
1999-10,Minnesota,2895,21302,24197,5303925
1999-10,Mississippi,5116,12980,18096,2967297
1999-10,Missouri,3639,19215,22854,5988927
1999-10,Montana,1614,7854,9468,989415
1999-10,Nebraska,55,4909,4964,1826341
1999-10,Nevada,2362,2541,4903,2700551
1999-10,New Hampshire,1515,3448,4963,1316470
1999-10,New Jersey,1396,2191,3587,8791894
1999-10,New Mexico,3091,6494,9585,2059179
1999-10,New York,877,14634,15511,19378102
1999-10,North Carolina,1532,19809,21341,9535483
1999-10,North Dakota,438,4290,4728,672591
1999-10,Ohio,10443,18780,29223,11536504
1999-10,Oklahoma,4687,11147,15834,3751351
1999-10,Oregon,4949,8591,13540,3831074
1999-10,Pennsylvania,1,53760,53761,12702379
1999-10,Rhode Island,447,578,1025,1052567
1999-10,South Carolina,4311,8038,12349,4625364
1999-10,South Dakota,414,5083,5497,814180
1999-10,Tennessee,10078,13346,23424,6346105
1999-10,Texas,19018,43469,62487,25145561
1999-10,Utah,1704,6232,7936,2763885
1999-10,Vermont,650,2460,3110,625741
1999-10,Virginia,7279,13316,20595,8001024
1999-10,Washington,3037,11136,14173,6724540
1999-10,West Virginia,3352,12793,16145,1852994
1999-10,Wisconsin,4123,20534,24657,5686986
1999-10,Wyoming,795,2406,3201,563626
1999-09,Alabama,6743,13170,19913,4779736
1999-09,Arizona,5840,6406,12246,6392017
1999-09,Arkansas,3547,12919,16466,2915918
1999-09,California,28771,33647,62418,37253956
1999-09,Colorado,8536,16074,24610,5029196
1999-09,Connecticut,1659,2103,3762,3574097
1999-09,Delaware,401,1096,1497,897934
1999-09,District of Columbia,0,0,0,601723
1999-09,Florida,9292,9495,18787,18801310
1999-09,Georgia,7114,12545,19659,9687653
1999-09,Idaho,1662,6041,7703,1567582
1999-09,Illinois,4850,9115,13965,12830632
1999-09,Indiana,1883,13143,15026,6483802
1999-09,Iowa,59,4845,4904,3046355
1999-09,Kansas,2492,5840,8332,2853118
1999-09,Kentucky,6606,13018,19624,4339367
1999-09,Louisiana,5237,14128,19365,4533372
1999-09,Maine,1211,4913,6124,1328361
1999-09,Maryland,159,4256,4415,5773552
1999-09,Massachusetts,927,883,1810,6547629
1999-09,Michigan,98,22204,22302,9883640
1999-09,Minnesota,2492,20823,23315,5303925
1999-09,Mississippi,4674,10099,14773,2967297
1999-09,Missouri,3048,14309,17357,5988927
1999-09,Montana,1552,5933,7485,989415
1999-09,Nebraska,36,3236,3272,1826341
1999-09,Nevada,2385,2793,5178,2700551
1999-09,New Hampshire,1357,2828,4185,1316470
1999-09,New Jersey,1153,1856,3009,8791894
1999-09,New Mexico,2655,4844,7499,2059179
1999-09,New York,803,11908,12711,19378102
1999-09,North Carolina,1348,15374,16722,9535483
1999-09,North Dakota,376,3748,4124,672591
1999-09,Ohio,8442,16519,24961,11536504
1999-09,Oklahoma,4123,9383,13506,3751351
1999-09,Oregon,4907,10486,15393,3831074
1999-09,Pennsylvania,0,42302,42302,12702379
1999-09,Rhode Island,344,438,782,1052567
1999-09,South Carolina,4235,7866,12101,4625364
1999-09,South Dakota,319,3621,3940,814180
1999-09,Tennessee,7853,11247,19100,6346105
1999-09,Texas,16751,43374,60125,25145561
1999-09,Utah,1720,5496,7216,2763885
1999-09,Vermont,602,1982,2584,625741
1999-09,Virginia,5995,11255,17250,8001024
1999-09,Washington,2203,8826,11029,6724540
1999-09,West Virginia,2987,8754,11741,1852994
1999-09,Wisconsin,3376,17921,21297,5686986
1999-09,Wyoming,778,2667,3445,563626
1999-08,Alabama,7123,9709,16832,4779736
1999-08,Arizona,5621,6008,11629,6392017
1999-08,Arkansas,3833,9013,12846,2915918
1999-08,California,28841,32619,61460,37253956
1999-08,Colorado,8272,11776,20048,5029196
1999-08,Connecticut,1740,1826,3566,3574097
1999-08,Delaware,422,830,1252,897934
1999-08,District of Columbia,2,0,2,601723
1999-08,Florida,9946,8591,18537,18801310
1999-08,Georgia,8045,10023,18068,9687653
1999-08,Idaho,1509,3971,5480,1567582
1999-08,Illinois,4988,8730,13718,12830632
1999-08,Indiana,2187,13033,15220,6483802
1999-08,Iowa,49,2902,2951,3046355
1999-08,Kansas,2686,5005,7691,2853118
1999-08,Kentucky,6730,11112,17842,4339367
1999-08,Louisiana,5092,9024,14116,4533372
1999-08,Maine,1103,2870,3973,1328361
1999-08,Maryland,140,3446,3586,5773552
1999-08,Massachusetts,850,732,1582,6547629
1999-08,Michigan,127,13770,13897,9883640
1999-08,Minnesota,2675,13076,15751,5303925
1999-08,Mississippi,4742,8211,12953,2967297
1999-08,Missouri,3085,11506,14591,5988927
1999-08,Montana,1597,4313,5910,989415
1999-08,Nebraska,29,2270,2299,1826341
1999-08,Nevada,2437,2216,4653,2700551
1999-08,New Hampshire,1277,2225,3502,1316470
1999-08,New Jersey,1295,1778,3073,8791894
1999-08,New Mexico,2821,4174,6995,2059179
1999-08,New York,838,7844,8682,19378102
1999-08,North Carolina,1389,13380,14769,9535483
1999-08,North Dakota,422,2277,2699,672591
1999-08,Ohio,8667,13157,21824,11536504
1999-08,Oklahoma,4229,7660,11889,3751351
1999-08,Oregon,4685,6592,11277,3831074
1999-08,Pennsylvania,0,40245,40245,12702379
1999-08,Rhode Island,371,401,772,1052567
1999-08,South Carolina,4493,6752,11245,4625364
1999-08,South Dakota,355,2358,2713,814180
1999-08,Tennessee,8830,10575,19405,6346105
1999-08,Texas,16585,35003,51588,25145561
1999-08,Utah,1697,3543,5240,2763885
1999-08,Vermont,499,1236,1735,625741
1999-08,Virginia,6305,8698,15003,8001024
1999-08,Washington,2397,6807,9204,6724540
1999-08,West Virginia,3068,6013,9081,1852994
1999-08,Wisconsin,3490,10463,13953,5686986
1999-08,Wyoming,868,1941,2809,563626
1999-07,Alabama,6770,7813,14583,4779736
1999-07,Arizona,5947,5073,11020,6392017
1999-07,Arkansas,3712,6560,10272,2915918
1999-07,California,27758,28825,56583,37253956
1999-07,Colorado,4733,5717,10450,5029196
1999-07,Connecticut,1572,1387,2959,3574097
1999-07,Delaware,345,544,889,897934
1999-07,District of Columbia,2,0,2,601723
1999-07,Florida,10279,7868,18147,18801310
1999-07,Georgia,7748,7333,15081,9687653
1999-07,Idaho,1600,3302,4902,1567582
1999-07,Illinois,5185,6368,11553,12830632
1999-07,Indiana,2205,10381,12586,6483802
1999-07,Iowa,52,1854,1906,3046355
1999-07,Kansas,2581,3434,6015,2853118
1999-07,Kentucky,7067,8455,15522,4339367
1999-07,Louisiana,5491,6563,12054,4533372
1999-07,Maine,871,1832,2703,1328361
1999-07,Maryland,149,2970,3119,5773552
1999-07,Massachusetts,689,592,1281,6547629
1999-07,Michigan,98,9275,9373,9883640
1999-07,Minnesota,2107,6130,8237,5303925
1999-07,Mississippi,5195,5707,10902,2967297
1999-07,Missouri,2949,8449,11398,5988927
1999-07,Montana,1564,3527,5091,989415
1999-07,Nebraska,34,1456,1490,1826341
1999-07,Nevada,2489,1901,4390,2700551
1999-07,New Hampshire,1138,1795,2933,1316470
1999-07,New Jersey,1317,1344,2661,8791894
1999-07,New Mexico,2656,3745,6401,2059179
1999-07,New York,778,5290,6068,19378102
1999-07,North Carolina,1494,9859,11353,9535483
1999-07,North Dakota,382,1556,1938,672591
1999-07,Ohio,7832,9201,17033,11536504
1999-07,Oklahoma,4099,6171,10270,3751351
1999-07,Oregon,4598,7134,11732,3831074
1999-07,Pennsylvania,10,32312,32322,12702379
1999-07,Rhode Island,362,326,688,1052567
1999-07,South Carolina,4369,4793,9162,4625364
1999-07,South Dakota,310,1447,1757,814180
1999-07,Tennessee,9415,8063,17478,6346105
1999-07,Texas,19189,24571,43760,25145561
1999-07,Utah,1712,2723,4435,2763885
1999-07,Vermont,441,865,1306,625741
1999-07,Virginia,6410,7664,14074,8001024
1999-07,Washington,2269,5745,8014,6724540
1999-07,West Virginia,3050,5278,8328,1852994
1999-07,Wisconsin,3258,6489,9747,5686986
1999-07,Wyoming,816,1572,2388,563626
1999-06,Alabama,7010,7393,14403,4779736
1999-06,Arizona,5771,4793,10564,6392017
1999-06,Arkansas,3822,6118,9940,2915918
1999-06,California,27990,28272,56262,37253956
1999-06,Colorado,4846,5733,10579,5029196
1999-06,Connecticut,1656,1361,3017,3574097
1999-06,Delaware,389,516,905,897934
1999-06,District of Columbia,1,0,1,601723
1999-06,Florida,10450,7647,18097,18801310
1999-06,Georgia,7703,6588,14291,9687653
1999-06,Idaho,1641,3109,4750,1567582
1999-06,Illinois,4863,6263,11126,12830632
1999-06,Indiana,2068,11960,14028,6483802
1999-06,Iowa,53,1636,1689,3046355
1999-06,Kansas,2613,3279,5892,2853118
1999-06,Kentucky,6780,7298,14078,4339367
1999-06,Louisiana,5473,5579,11052,4533372
1999-06,Maine,791,1424,2215,1328361
1999-06,Maryland,105,2864,2969,5773552
1999-06,Massachusetts,625,539,1164,6547629
1999-06,Michigan,119,7716,7835,9883640
1999-06,Minnesota,2177,5587,7764,5303925
1999-06,Mississippi,4744,4927,9671,2967297
1999-06,Missouri,3147,8349,11496,5988927
1999-06,Montana,1556,3574,5130,989415
1999-06,Nebraska,39,1305,1344,1826341
1999-06,Nevada,2402,1963,4365,2700551
1999-06,New Hampshire,1101,1402,2503,1316470
1999-06,New Jersey,1385,1310,2695,8791894
1999-06,New Mexico,2909,3765,6674,2059179
1999-06,New York,709,5039,5748,19378102
1999-06,North Carolina,1401,9570,10971,9535483
1999-06,North Dakota,372,1235,1607,672591
1999-06,Ohio,7642,8516,16158,11536504
1999-06,Oklahoma,4280,6135,10415,3751351
1999-06,Oregon,4896,5992,10888,3831074
1999-06,Pennsylvania,0,33462,33462,12702379
1999-06,Rhode Island,369,312,681,1052567
1999-06,South Carolina,4154,3947,8101,4625364
1999-06,South Dakota,276,1176,1452,814180
1999-06,Tennessee,9103,6807,15910,6346105
1999-06,Texas,17081,21918,38999,25145561
1999-06,Utah,1697,2615,4312,2763885
1999-06,Vermont,430,705,1135,625741
1999-06,Virginia,5730,7254,12984,8001024
1999-06,Washington,2331,5796,8127,6724540
1999-06,West Virginia,2861,4481,7342,1852994
1999-06,Wisconsin,3552,5576,9128,5686986
1999-06,Wyoming,868,1513,2381,563626
1999-05,Alabama,7005,6832,13837,4779736
1999-05,Arizona,6301,4732,11033,6392017
1999-05,Arkansas,3834,5532,9366,2915918
1999-05,California,27813,25075,52888,37253956
1999-05,Colorado,4945,5279,10224,5029196
1999-05,Connecticut,2204,1410,3614,3574097
1999-05,Delaware,497,576,1073,897934
1999-05,District of Columbia,1,0,1,601723
1999-05,Florida,10183,7355,17538,18801310
1999-05,Georgia,8208,6245,14453,9687653
1999-05,Idaho,1876,3291,5167,1567582
1999-05,Illinois,5654,6596,12250,12830632
1999-05,Indiana,2153,13020,15173,6483802
1999-05,Iowa,63,1594,1657,3046355
1999-05,Kansas,2675,3163,5838,2853118
1999-05,Kentucky,6785,6694,13479,4339367
1999-05,Louisiana,5282,4795,10077,4533372
1999-05,Maine,1000,1449,2449,1328361
1999-05,Maryland,99,2650,2749,5773552
1999-05,Massachusetts,605,533,1138,6547629
1999-05,Michigan,102,8594,8696,9883640
1999-05,Minnesota,2063,5046,7109,5303925
1999-05,Mississippi,4847,4403,9250,2967297
1999-05,Missouri,3354,8379,11733,5988927
1999-05,Montana,1638,3461,5099,989415
1999-05,Nebraska,35,1292,1327,1826341
1999-05,Nevada,2491,2021,4512,2700551
1999-05,New Hampshire,1221,1548,2769,1316470
1999-05,New Jersey,1372,1285,2657,8791894
1999-05,New Mexico,2857,3501,6358,2059179
1999-05,New York,924,5741,6665,19378102
1999-05,North Carolina,1333,8866,10199,9535483
1999-05,North Dakota,467,1267,1734,672591
1999-05,Ohio,9014,8621,17635,11536504
1999-05,Oklahoma,4443,5946,10389,3751351
1999-05,Oregon,5061,5979,11040,3831074
1999-05,Pennsylvania,20,35757,35777,12702379
1999-05,Rhode Island,395,320,715,1052567
1999-05,South Carolina,4594,3659,8253,4625364
1999-05,South Dakota,311,1169,1480,814180
1999-05,Tennessee,8924,6335,15259,6346105
1999-05,Texas,17729,21511,39240,25145561
1999-05,Utah,2308,2928,5236,2763885
1999-05,Vermont,411,728,1139,625741
1999-05,Virginia,6627,6895,13522,8001024
1999-05,Washington,2151,5593,7744,6724540
1999-05,West Virginia,3005,4239,7244,1852994
1999-05,Wisconsin,4722,5966,10688,5686986
1999-05,Wyoming,927,1422,2349,563626
1999-04,Alabama,7371,7218,14589,4779736
1999-04,Arizona,7249,5111,12360,6392017
1999-04,Arkansas,4308,6619,10927,2915918
1999-04,California,28837,24367,53204,37253956
1999-04,Colorado,5235,6010,11245,5029196
1999-04,Connecticut,2188,1748,3936,3574097
1999-04,Delaware,451,610,1061,897934
1999-04,District of Columbia,2,0,2,601723
1999-04,Florida,10294,7510,17804,18801310
1999-04,Georgia,8514,6793,15307,9687653
1999-04,Idaho,1808,3682,5490,1567582
1999-04,Illinois,7198,7127,14325,12830632
1999-04,Indiana,2671,13844,16515,6483802
1999-04,Iowa,70,2258,2328,3046355
1999-04,Kansas,2677,3869,6546,2853118
1999-04,Kentucky,7669,9417,17086,4339367
1999-04,Louisiana,5535,5018,10553,4533372
1999-04,Maine,1066,1645,2711,1328361
1999-04,Maryland,146,3074,3220,5773552
1999-04,Massachusetts,708,672,1380,6547629
1999-04,Michigan,121,10964,11085,9883640
1999-04,Minnesota,2455,6750,9205,5303925
1999-04,Mississippi,5609,4987,10596,2967297
1999-04,Missouri,4141,11024,15165,5988927
1999-04,Montana,1799,3930,5729,989415
1999-04,Nebraska,70,1451,1521,1826341
1999-04,Nevada,2623,2008,4631,2700551
1999-04,New Hampshire,1061,1866,2927,1316470
1999-04,New Jersey,1504,1463,2967,8791894
1999-04,New Mexico,2959,3966,6925,2059179
1999-04,New York,1067,8127,9194,19378102
1999-04,North Carolina,1450,10117,11567,9535483
1999-04,North Dakota,402,1332,1734,672591
1999-04,Ohio,10629,11498,22127,11536504
1999-04,Oklahoma,4812,7128,11940,3751351
1999-04,Oregon,5575,6773,12348,3831074
1999-04,Pennsylvania,21,41718,41739,12702379
1999-04,Rhode Island,400,360,760,1052567
1999-04,South Carolina,4659,4085,8744,4625364
1999-04,South Dakota,353,1406,1759,814180
1999-04,Tennessee,9218,7537,16755,6346105
1999-04,Texas,17864,22130,39994,25145561
1999-04,Utah,2624,3234,5858,2763885
1999-04,Vermont,497,1078,1575,625741
1999-04,Virginia,6437,7324,13761,8001024
1999-04,Washington,1963,5825,7788,6724540
1999-04,West Virginia,3425,6299,9724,1852994
1999-04,Wisconsin,6667,8260,14927,5686986
1999-04,Wyoming,1008,1469,2477,563626
1999-03,Alabama,9151,9991,19142,4779736
1999-03,Arizona,7261,5248,12509,6392017
1999-03,Arkansas,4886,8543,13429,2915918
1999-03,California,32639,28097,60736,37253956
1999-03,Colorado,7867,8754,16621,5029196
1999-03,Connecticut,2042,2132,4174,3574097
1999-03,Delaware,572,731,1303,897934
1999-03,District of Columbia,2,0,2,601723
1999-03,Florida,12149,9442,21591,18801310
1999-03,Georgia,9823,9705,19528,9687653
1999-03,Idaho,2014,3889,5903,1567582
1999-03,Illinois,8727,9286,18013,12830632
1999-03,Indiana,3426,13502,16928,6483802
1999-03,Iowa,55,2984,3039,3046355
1999-03,Kansas,3905,4900,8805,2853118
1999-03,Kentucky,9397,10944,20341,4339367
1999-03,Louisiana,7320,6696,14016,4533372
1999-03,Maine,1304,2005,3309,1328361
1999-03,Maryland,212,3717,3929,5773552
1999-03,Massachusetts,657,755,1412,6547629
1999-03,Michigan,217,12207,12424,9883640
1999-03,Minnesota,2442,7366,9808,5303925
1999-03,Mississippi,6818,6875,13693,2967297
1999-03,Missouri,5087,12245,17332,5988927
1999-03,Montana,1933,4024,5957,989415
1999-03,Nebraska,79,1722,1801,1826341
1999-03,Nevada,2850,2310,5160,2700551
1999-03,New Hampshire,59,1801,1860,1316470
1999-03,New Jersey,1578,1641,3219,8791894
1999-03,New Mexico,3554,4591,8145,2059179
1999-03,New York,1202,7868,9070,19378102
1999-03,North Carolina,1523,12332,13855,9535483
1999-03,North Dakota,507,1538,2045,672591
1999-03,Ohio,12176,12276,24452,11536504
1999-03,Oklahoma,5309,7724,13033,3751351
1999-03,Oregon,5992,7098,13090,3831074
1999-03,Pennsylvania,0,48470,48470,12702379
1999-03,Rhode Island,481,395,876,1052567
1999-03,South Carolina,5516,5861,11377,4625364
1999-03,South Dakota,351,1489,1840,814180
1999-03,Tennessee,12141,10581,22722,6346105
1999-03,Texas,21305,25971,47276,25145561
1999-03,Utah,2479,3434,5913,2763885
1999-03,Vermont,699,1219,1918,625741
1999-03,Virginia,8401,8593,16994,8001024
1999-03,Washington,2528,6504,9032,6724540
1999-03,West Virginia,4194,6503,10697,1852994
1999-03,Wisconsin,5661,9218,14879,5686986
1999-03,Wyoming,986,1574,2560,563626
1999-02,Alabama,9630,10654,20284,4779736
1999-02,Arizona,7157,5251,12408,6392017
1999-02,Arkansas,5382,9655,15037,2915918
1999-02,California,27909,23847,51756,37253956
1999-02,Colorado,10028,11384,21412,5029196
1999-02,Connecticut,1736,1802,3538,3574097
1999-02,Delaware,477,588,1065,897934
1999-02,District of Columbia,2,1,3,601723
1999-02,Florida,11269,9182,20451,18801310
1999-02,Georgia,11288,10565,21853,9687653
1999-02,Idaho,1808,3228,5036,1567582
1999-02,Illinois,8106,8088,16194,12830632
1999-02,Indiana,3260,12695,15955,6483802
1999-02,Iowa,60,2692,2752,3046355
1999-02,Kansas,3335,4170,7505,2853118
1999-02,Kentucky,9961,11874,21835,4339367
1999-02,Louisiana,7259,6550,13809,4533372
1999-02,Maine,1110,1574,2684,1328361
1999-02,Maryland,186,3479,3665,5773552
1999-02,Massachusetts,406,599,1005,6547629
1999-02,Michigan,102,9982,10084,9883640
1999-02,Minnesota,1559,5084,6643,5303925
1999-02,Mississippi,7988,7681,15669,2967297
1999-02,Missouri,4175,12484,16659,5988927
1999-02,Montana,1615,3250,4865,989415
1999-02,Nebraska,54,1604,1658,1826341
1999-02,Nevada,2617,2067,4684,2700551
1999-02,New Hampshire,44,1405,1449,1316470
1999-02,New Jersey,1234,1337,2571,8791894
1999-02,New Mexico,3030,4489,7519,2059179
1999-02,New York,865,6474,7339,19378102
1999-02,North Carolina,2065,13078,15143,9535483
1999-02,North Dakota,387,1202,1589,672591
1999-02,Ohio,11757,11321,23078,11536504
1999-02,Oklahoma,5792,8527,14319,3751351
1999-02,Oregon,5332,5811,11143,3831074
1999-02,Pennsylvania,0,37810,37810,12702379
1999-02,Rhode Island,445,316,761,1052567
1999-02,South Carolina,6045,6057,12102,4625364
1999-02,South Dakota,318,1354,1672,814180
1999-02,Tennessee,12332,10629,22961,6346105
1999-02,Texas,21500,27078,48578,25145561
1999-02,Utah,2575,3244,5819,2763885
1999-02,Vermont,656,998,1654,625741
1999-02,Virginia,7688,8187,15875,8001024
1999-02,Washington,2287,6003,8290,6724540
1999-02,West Virginia,3987,7019,11006,1852994
1999-02,Wisconsin,3584,6982,10566,5686986
1999-02,Wyoming,831,1584,2415,563626
1999-01,Alabama,7516,10311,17827,4779736
1999-01,Arizona,5937,4939,10876,6392017
1999-01,Arkansas,3720,7932,11652,2915918
1999-01,California,25989,23653,49642,37253956
1999-01,Colorado,8336,10484,18820,5029196
1999-01,Connecticut,1636,1563,3199,3574097
1999-01,Delaware,419,702,1121,897934
1999-01,District of Columbia,0,1,1,601723
1999-01,Florida,9287,8559,17846,18801310
1999-01,Georgia,6131,6081,12212,9687653
1999-01,Idaho,1738,2922,4660,1567582
1999-01,Illinois,6131,6989,13120,12830632
1999-01,Indiana,2552,12777,15329,6483802
1999-01,Iowa,49,2538,2587,3046355
1999-01,Kansas,2854,5002,7856,2853118
1999-01,Kentucky,7938,9634,17572,4339367
1999-01,Louisiana,5506,7174,12680,4533372
1999-01,Maine,895,1394,2289,1328361
1999-01,Maryland,283,3401,3684,5773552
1999-01,Massachusetts,283,553,836,6547629
1999-01,Michigan,92,8283,8375,9883640
1999-01,Minnesota,1049,3736,4785,5303925
1999-01,Mississippi,4989,7294,12283,2967297
1999-01,Missouri,3072,10250,13322,5988927
1999-01,Montana,1300,2890,4190,989415
1999-01,Nebraska,74,1701,1775,1826341
1999-01,Nevada,2596,1985,4581,2700551
1999-01,New Hampshire,35,1415,1450,1316470
1999-01,New Jersey,1156,1302,2458,8791894
1999-01,New Mexico,2581,3956,6537,2059179
1999-01,New York,882,5327,6209,19378102
1999-01,North Carolina,1570,11401,12971,9535483
1999-01,North Dakota,336,991,1327,672591
1999-01,Ohio,7737,8708,16445,11536504
1999-01,Oklahoma,4322,7526,11848,3751351
1999-01,Oregon,4611,4869,9480,3831074
1999-01,Pennsylvania,4,30257,30261,12702379
1999-01,Rhode Island,412,402,814,1052567
1999-01,South Carolina,4397,5031,9428,4625364
1999-01,South Dakota,220,1159,1379,814180
1999-01,Tennessee,9581,8696,18277,6346105
1999-01,Texas,18123,26179,44302,25145561
1999-01,Utah,2041,2936,4977,2763885
1999-01,Vermont,427,605,1032,625741
1999-01,Virginia,6298,7556,13854,8001024
1999-01,Washington,1891,5780,7671,6724540
1999-01,West Virginia,2989,5118,8107,1852994
1999-01,Wisconsin,2709,5063,7772,5686986
1999-01,Wyoming,668,1401,2069,563626
